3553,0.000122,1,2,3,14.199095341257646,#717171
1,0.000251,4,0,4,22.21639170604164,#6c6c6c
3586,0.000094,0,2,2,12,#737373
3587,0.000094,0,2,2,12,#737373
3637,0.000094,0,3,3,12,#737373
3583,0.00012,1,2,3,14.050122216323361,#717171
2,0.000145,1,0,1,15.839461562490118,#707070
4930,0.000213,2,1,3,20.103098863481684,#6d6d6d
3,0.000274,1,0,1,23.425704036241918,#6b6b6b
88,0.000387,5,3,8,28.79818377446482,#676767
4,0.000203,1,0,1,19.51934882871322,#6d6d6d
13,0.000725,3,2,5,41.606179027435296,#5e5e5e
5,0.000442,2,0,2,31.153303542073253,#656565
120,0.000094,0,2,2,12,#737373
8,0.000597,1,2,3,37.16097463850524,#616161
6,0.000347,1,0,1,26.989224450772824,#686868
7,0.000347,1,0,1,26.989224450772824,#686868
9,0.000592,5,1,6,36.97903361817941,#616161
10,0.000209,1,1,2,19.871111006625867,#6d6d6d
61,0.000266,2,1,3,23.01044912007304,#6b6b6b
75,0.000094,0,2,2,12,#737373
205,0.000109,1,6,7,13.209951757949934,#727272
208,0.000094,0,2,2,12,#737373
50,0.000136,2,1,3,15.212609940615039,#717171
94,0.000282,2,5,7,23.835537796096794,#6a6a6a
11,0.000198,2,0,2,19.222623922752323,#6e6e6e
125,0.000133,1,2,3,14.999536055771733,#717171
12,0.000402,1,0,1,29.454654404936605,#666666
14,0.000473,4,1,5,32.422614581769096,#646464
15,0.000094,0,1,1,12,#737373
83,0.000177,2,1,3,17.937795520999256,#6f6f6f
16,0.000094,0,1,1,12,#737373
17,0.000094,0,1,1,12,#737373
29,0.000213,2,1,3,20.103098863481684,#6d6d6d
147,0.000094,0,2,2,12,#737373
19,0.000242,2,1,3,21.729683399131453,#6c6c6c
18,0.000339,2,0,2,26.61636755519475,#686868
190,0.000094,0,2,2,12,#737373
20,0.000128,1,1,2,14.639545810903515,#717171
130,0.000094,0,2,2,12,#737373
199,0.00012,1,3,4,14.050122216323361,#717171
51,0.00016,2,1,3,16.846537660321623,#6f6f6f
21,0.000269,2,0,2,23.166819740335022,#6b6b6b
176,0.000094,0,2,2,12,#737373
4445,0.000111,1,2,3,13.365453519669122,#727272
22,0.000141,1,0,1,15.56308822919205,#707070
4446,0.000107,1,5,6,13.05316063235918,#727272
23,0.000112,1,0,1,13.442731432222969,#727272
53,0.000133,1,1,2,14.999536055771733,#717171
24,0.00022,2,0,2,20.50441114623677,#6d6d6d
4461,0.000094,0,6,6,12,#737373
58,0.00034,2,2,4,26.66318959447377,#686868
25,0.000468,2,0,2,32.220476738241295,#656565
136,0.000271,1,1,2,23.270631146211333,#6b6b6b
26,0.000299,4,0,4,24.689427409048697,#6a6a6a
131,0.00012,1,2,3,14.050122216323361,#717171
139,0.000126,1,4,5,14.493782114686502,#717171
203,0.000094,0,1,1,12,#737373
161,0.000133,1,1,2,14.999536055771733,#717171
27,0.00032,2,0,2,25.714617749683157,#696969
166,0.000133,1,1,2,14.999536055771733,#717171
98,0.000347,4,5,9,26.989224450772824,#686868
28,0.000153,1,0,1,16.382109723928565,#707070
160,0.000094,0,1,1,12,#737373
123,0.000126,1,4,5,14.493782114686502,#717171
30,0.000153,2,0,2,16.382109723928565,#707070
140,0.00019,2,5,7,18.740756670053315,#6e6e6e
62,0.000176,1,1,2,17.874947243038193,#6f6f6f
31,0.000388,2,0,2,28.842300770516935,#676767
104,0.000171,2,1,3,17.5582653966192,#6f6f6f
155,0.000094,0,2,2,12,#737373
32,0.000171,2,0,2,17.5582653966192,#6f6f6f
174,0.000133,1,3,4,14.999536055771733,#717171
34,0.000688,2,1,3,40.36034047916147,#5f5f5f
33,0.000679,1,0,1,40.052773047515174,#5f5f5f
35,0.000653,4,1,5,39.1537805543618,#606060
97,0.000094,0,2,2,12,#737373
36,0.000395,5,1,6,29.149698491158492,#676767
69,0.000448,4,3,7,31.402028585233786,#656565
141,0.000133,1,2,3,14.999536055771733,#717171
142,0.000094,0,2,2,12,#737373
37,0.000094,0,1,1,12,#737373
38,0.000094,0,1,1,12,#737373
39,0.000094,0,1,1,12,#737373
47,0.00012,1,4,5,14.050122216323361,#717171
157,0.000133,1,3,4,14.999536055771733,#717171
40,0.000173,2,0,2,17.685431661066666,#6f6f6f
202,0.000094,0,2,2,12,#737373
42,0.000192,2,1,3,18.862066054200255,#6e6e6e
41,0.000507,5,0,5,33.772434019112126,#636363
167,0.000094,0,2,2,12,#737373
218,0.000094,0,3,3,12,#737373
232,0.000094,0,2,2,12,#737373
181,0.000094,0,2,2,12,#737373
43,0.000226,2,0,2,20.843841544046825,#6d6d6d
163,0.0002,2,2,4,19.341713958828393,#6e6e6e
44,0.000119,1,0,1,13.975216770645698,#727272
45,0.000119,1,0,1,13.975216770645698,#727272
46,0.000148,2,0,2,16.044496277075513,#707070
184,0.000173,2,5,7,17.685431661066666,#6f6f6f
171,0.000094,0,3,3,12,#737373
48,0.000589,3,0,3,36.86953699486444,#616161
101,0.000403,2,1,3,29.498023818295955,#666666
106,0.000133,1,1,2,14.999536055771733,#717171
4448,0.000123,1,6,7,14.27316966065317,#717171
49,0.000111,1,0,1,13.365453519669122,#727272
194,0.000094,0,3,3,12,#737373
111,0.000216,3,1,4,20.275805650131435,#6d6d6d
52,0.000385,3,0,3,28.709795603215216,#676767
119,0.00016,2,2,4,16.846537660321623,#6f6f6f
172,0.000094,0,2,2,12,#737373
231,0.000094,0,2,2,12,#737373
109,0.000094,0,2,2,12,#737373
54,0.000173,2,0,2,17.685431661066666,#6f6f6f
55,0.000305,2,0,2,24.98555638836362,#6a6a6a
107,0.00012,1,1,2,14.050122216323361,#717171
56,0.000452,5,0,5,31.567013188193116,#656565
149,0.000128,1,1,2,14.639545810903515,#717171
152,0.000128,1,1,2,14.639545810903515,#717171
175,0.000094,0,2,2,12,#737373
198,0.00016,2,4,6,16.846537660321623,#6f6f6f
57,0.000232,2,0,2,21.179240350145598,#6c6c6c
2562,0.000279,4,3,7,23.682471018741992,#6b6b6b
59,0.000243,1,1,2,21.78415975388338,#6c6c6c
60,0.000176,1,1,2,17.874947243038193,#6f6f6f
154,0.00029,4,3,7,24.24017204011931,#6a6a6a
188,0.000109,1,1,2,13.209951757949934,#727272
209,0.000094,0,1,1,12,#737373
68,0.000458,3,3,6,31.813263221565485,#656565
63,0.000223,1,0,1,20.67464007448106,#6d6d6d
64,0.000223,1,0,1,20.67464007448106,#6d6d6d
65,0.000223,1,0,1,20.67464007448106,#6d6d6d
66,0.00022,1,0,1,20.50441114623677,#6d6d6d
70,0.000484,1,2,3,32.86396157709246,#646464
67,0.000299,1,0,1,24.689427409048697,#6a6a6a
979,0.000247,2,1,3,22.0010632357656,#6c6c6c
4893,0.000133,1,4,5,14.999536055771733,#717171
1030,0.000474,5,5,10,32.46292656670499,#646464
1052,0.000133,1,4,5,14.999536055771733,#717171
2344,0.000094,0,2,2,12,#737373
108,0.000459,3,1,4,31.85416342574387,#656565
86,0.000133,1,2,3,14.999536055771733,#717171
71,0.000177,2,0,2,17.937795520999256,#6f6f6f
224,0.000094,0,3,3,12,#737373
73,0.00026,2,1,3,22.69530774034737,#6b6b6b
72,0.000601,3,0,3,37.30603427027346,#616161
112,0.000306,2,1,3,25.034655451212537,#6a6a6a
215,0.000094,0,3,3,12,#737373
91,0.000149,2,1,3,16.112424734781012,#707070
74,0.000153,1,0,1,16.382109723928565,#707070
77,0.000154,2,1,3,16.449033409962986,#707070
76,0.000463,4,0,4,32.01736471555461,#656565
110,0.000094,0,2,2,12,#737373
185,0.000167,1,1,2,17.301908082944657,#6f6f6f
170,0.00012,1,3,4,14.050122216323361,#717171
191,0.000094,0,3,3,12,#737373
79,0.000275,1,1,2,23.477225028974956,#6b6b6b
78,0.000367,2,0,2,27.9048006397121,#686868
80,0.000214,3,1,4,20.160788703714612,#6d6d6d
989,0.000133,1,2,3,14.999536055771733,#717171
82,0.000153,1,1,2,16.382109723928565,#707070
81,0.000302,2,0,2,24.8378228436656,#6a6a6a
221,0.000133,1,2,3,14.999536055771733,#717171
84,0.000125,2,0,2,14.420509920674892,#717171
151,0.000094,0,2,2,12,#737373
85,0.000151,2,0,2,16.24766909105304,#707070
87,0.000283,2,0,2,23.88639704795272,#6a6a6a
89,0.000094,0,1,1,12,#737373
90,0.000094,0,1,1,12,#737373
178,0.000094,0,3,3,12,#737373
195,0.000133,1,1,2,14.999536055771733,#717171
496,0.000133,1,3,4,14.999536055771733,#717171
92,0.000206,3,0,3,19.695806249957098,#6d6d6d
93,0.000142,1,0,1,15.632508821476176,#707070
95,0.000162,2,1,3,16.977542788511858,#6f6f6f
129,0.000246,3,5,8,21.94698647096437,#6c6c6c
144,0.00015,1,1,2,16.180148347028588,#707070
96,0.000248,2,0,2,22.055041569506876,#6c6c6c
148,0.000094,0,3,3,12,#737373
100,0.000094,0,2,2,12,#737373
135,0.000167,1,1,2,17.301908082944657,#6f6f6f
99,0.000173,2,0,2,17.685431661066666,#6f6f6f
4459,0.000094,0,2,2,12,#737373
210,0.000332,3,1,4,26.28685674490043,#696969
102,0.000126,1,0,1,14.493782114686502,#717171
145,0.00016,2,1,3,16.846537660321623,#6f6f6f
103,0.000384,3,0,3,28.665524040933125,#676767
153,0.000406,4,3,7,29.627842349289,#666666
222,0.000094,0,2,2,12,#737373
105,0.00023,3,0,3,21.067879224360784,#6c6c6c
1055,0.000094,0,3,3,12,#737373
186,0.000094,0,2,2,12,#737373
116,0.000347,4,1,5,26.989224450772824,#686868
207,0.000094,0,5,5,12,#737373
4120,0.000193,2,3,5,18.92250746755846,#6e6e6e
192,0.000133,1,2,3,14.999536055771733,#717171
204,0.000094,0,2,2,12,#737373
113,0.000218,2,1,3,20.390344347943245,#6d6d6d
3770,0.000196,1,2,3,19.102991324867094,#6e6e6e
115,0.000109,1,1,2,13.209951757949934,#727272
114,0.000186,1,0,1,18.496400996337503,#6e6e6e
117,0.000094,0,1,1,12,#737373
118,0.000094,0,1,1,12,#737373
522,0.000186,2,2,4,18.496400996337503,#6e6e6e
122,0.00012,1,1,2,14.050122216323361,#717171
121,0.000196,1,0,1,19.102991324867094,#6e6e6e
124,0.000315,4,0,4,25.473340498053965,#696969
173,0.000094,0,2,2,12,#737373
126,0.000135,1,0,1,15.141822520724293,#717171
127,0.000135,1,0,1,15.141822520724293,#717171
128,0.000135,1,0,1,15.141822520724293,#717171
235,0.000094,0,1,1,12,#737373
4112,0.000133,1,2,3,14.999536055771733,#717171
132,0.000107,1,0,1,13.05316063235918,#727272
133,0.000173,1,0,1,17.685431661066666,#6f6f6f
134,0.000207,2,0,2,19.754368044230688,#6d6d6d
236,0.000173,1,2,3,17.685431661066666,#6f6f6f
146,0.000209,1,1,2,19.871111006625867,#6d6d6d
223,0.000133,1,1,2,14.999536055771733,#717171
137,0.00026,3,0,3,22.69530774034737,#6b6b6b
229,0.000094,0,3,3,12,#737373
138,0.000525,6,0,6,34.47054204663135,#636363
143,0.000213,3,1,4,20.103098863481684,#6d6d6d
150,0.00016,2,1,3,16.846537660321623,#6f6f6f
4882,0.000094,0,2,2,12,#737373
234,0.000094,0,2,2,12,#737373
196,0.000094,0,2,2,12,#737373
156,0.000133,1,1,2,14.999536055771733,#717171
158,0.000094,0,1,1,12,#737373
159,0.000094,0,1,1,12,#737373
189,0.000094,0,2,2,12,#737373
193,0.000094,0,2,2,12,#737373
162,0.000258,2,0,2,22.58953495795189,#6b6b6b
165,0.000094,0,1,1,12,#737373
164,0.000094,0,1,1,12,#737373
168,0.000154,2,0,2,16.449033409962986,#707070
169,0.000241,3,0,3,21.675105650777578,#6c6c6c
187,0.000173,2,2,4,17.685431661066666,#6f6f6f
227,0.000094,0,2,2,12,#737373
177,0.000387,3,0,3,28.79818377446482,#676767
179,0.000221,2,1,3,20.56126952844315,#6d6d6d
180,0.000094,0,1,1,12,#737373
206,0.000109,1,1,2,13.209951757949934,#727272
182,0.000123,1,0,1,14.27316966065317,#717171
183,0.000123,1,0,1,14.27316966065317,#717171
200,0.000094,0,2,2,12,#737373
997,0.00014,2,3,5,15.493445725621832,#707070
228,0.000094,0,2,2,12,#737373
230,0.000094,0,2,2,12,#737373
201,0.000094,0,3,3,12,#737373
197,0.00012,1,0,1,14.050122216323361,#717171
211,0.000094,0,1,1,12,#737373
212,0.000094,0,1,1,12,#737373
213,0.000094,0,1,1,12,#737373
214,0.00016,2,0,2,16.846537660321623,#6f6f6f
499,0.000094,0,2,2,12,#737373
225,0.000094,0,2,2,12,#737373
216,0.000173,2,0,2,17.685431661066666,#6f6f6f
217,0.00012,1,0,1,14.050122216323361,#717171
219,0.00012,1,0,1,14.050122216323361,#717171
220,0.00015,1,0,1,16.180148347028588,#707070
226,0.00016,2,0,2,16.846537660321623,#6f6f6f
233,0.000133,1,0,1,14.999536055771733,#717171
237,0.000094,0,1,1,12,#737373
252,0.000519,4,2,6,34.239053660634575,#636363
238,0.00048,3,0,3,32.70399923280961,#646464
318,0.000204,1,2,3,19.57829755448963,#6d6d6d
4423,0.000094,0,1,1,12,#737373
240,0.000344,3,1,4,26.849861079186745,#686868
239,0.000528,3,0,3,34.585839706295715,#636363
333,0.000094,0,2,2,12,#737373
354,0.000241,1,2,3,21.675105650777578,#6c6c6c
316,0.000113,1,6,7,13.5196994710513,#727272
327,0.000253,2,1,3,22.323476700598142,#6b6b6b
337,0.000094,0,4,4,12,#737373
242,0.000396,5,1,6,29.193411658840844,#676767
241,0.000462,2,0,2,31.976624070929397,#656565
351,0.000113,1,3,4,13.5196994710513,#727272
284,0.000301,4,4,8,24.78843171388773,#6a6a6a
363,0.000094,0,1,1,12,#737373
364,0.000094,0,1,1,12,#737373
365,0.000094,0,2,2,12,#737373
366,0.000094,0,2,2,12,#737373
342,0.000162,2,2,4,16.977542788511858,#6f6f6f
243,0.000191,2,0,2,18.801482814356014,#6e6e6e
355,0.000133,1,4,5,14.999536055771733,#717171
335,0.000173,1,3,4,17.685431661066666,#6f6f6f
244,0.000189,2,0,2,18.67988652940294,#6e6e6e
361,0.000109,1,2,3,13.209951757949934,#727272
247,0.000196,1,2,3,19.102991324867094,#6e6e6e
245,0.000177,1,0,1,17.937795520999256,#6f6f6f
246,0.000717,5,0,5,41.33927895328642,#5e5e5e
257,0.000426,5,1,6,30.48250242520127,#666666
298,0.000218,3,3,6,20.390344347943245,#6d6d6d
371,0.000113,1,1,2,13.5196994710513,#727272
378,0.000094,0,4,4,12,#737373
330,0.000241,1,2,3,21.675105650777578,#6c6c6c
250,0.000094,0,2,2,12,#737373
248,0.000133,1,0,1,14.999536055771733,#717171
249,0.000344,6,0,6,26.849861079186745,#686868
280,0.000214,4,2,6,20.160788703714612,#6d6d6d
305,0.000135,2,4,6,15.141822520724293,#717171
312,0.000103,1,2,3,12.735568257100576,#727272
313,0.000094,0,8,8,12,#737373
360,0.000133,1,3,4,14.999536055771733,#717171
251,0.000757,5,0,5,42.66076485691046,#5d5d5d
289,0.000094,0,2,2,12,#737373
319,0.000323,3,1,4,25.858570168259796,#696969
367,0.00012,1,1,2,14.050122216323361,#717171
370,0.000094,0,3,3,12,#737373
253,0.000313,2,1,3,25.376347528504994,#696969
322,0.000094,0,2,2,12,#737373
376,0.000094,0,1,1,12,#737373
4362,0.000235,1,1,2,21.345475258565315,#6c6c6c
255,0.000212,2,1,3,20.045287013917818,#6d6d6d
254,0.000504,3,0,3,33.65500504372394,#646464
329,0.000196,1,1,2,19.102991324867094,#6e6e6e
285,0.000195,3,2,5,19.04296905860749,#6e6e6e
299,0.000126,2,3,5,14.493782114686502,#717171
259,0.000094,0,2,2,12,#737373
256,0.000133,1,0,1,14.999536055771733,#717171
310,0.000207,2,1,3,19.754368044230688,#6d6d6d
368,0.000094,0,2,2,12,#737373
381,0.000094,0,2,2,12,#737373
258,0.000234,3,0,3,21.290170301890548,#6c6c6c
306,0.00011,1,3,4,13.28786167716395,#727272
311,0.000173,2,2,4,17.685431661066666,#6f6f6f
261,0.000313,3,1,4,25.376347528504994,#696969
260,0.000623,5,0,5,38.09621770964164,#616161
287,0.000126,1,1,2,14.493782114686502,#717171
350,0.000133,1,3,4,14.999536055771733,#717171
369,0.000094,0,2,2,12,#737373
382,0.000094,0,1,1,12,#737373
262,0.000173,2,1,3,17.685431661066666,#6f6f6f
267,0.000094,0,2,2,12,#737373
334,0.000113,1,3,4,13.5196994710513,#727272
344,0.000094,0,2,2,12,#737373
345,0.000094,0,2,2,12,#737373
321,0.00023,1,2,3,21.067879224360784,#6c6c6c
263,0.000218,2,0,2,20.390344347943245,#6d6d6d
4415,0.000094,0,3,3,12,#737373
281,0.000126,1,1,2,14.493782114686502,#717171
264,0.000233,2,0,2,21.234758886801874,#6c6c6c
308,0.000232,2,2,4,21.179240350145598,#6c6c6c
265,0.000192,1,0,1,18.862066054200255,#6e6e6e
266,0.000171,2,0,2,17.5582653966192,#6f6f6f
269,0.000149,2,1,3,16.112424734781012,#707070
268,0.00022,1,0,1,20.50441114623677,#6d6d6d
346,0.000094,0,2,2,12,#737373
362,0.000094,0,5,5,12,#737373
274,0.000215,3,4,7,20.218357360452792,#6d6d6d
270,0.000139,1,0,1,15.423579008661793,#707070
271,0.000139,1,0,1,15.423579008661793,#707070
272,0.000219,2,0,2,20.447436343276856,#6d6d6d
372,0.000094,0,1,1,12,#737373
273,0.000139,1,0,1,15.423579008661793,#707070
275,0.000094,0,1,1,12,#737373
325,0.000094,0,3,3,12,#737373
286,0.000094,0,1,1,12,#737373
276,0.000205,2,0,2,19.63711638898998,#6d6d6d
314,0.000368,2,1,3,27.949982322878284,#686868
277,0.000475,2,0,2,32.50320029889517,#646464
278,0.000224,3,0,3,20.731153739353275,#6d6d6d
279,0.000521,5,0,5,34.31634961942269,#636363
282,0.000267,4,1,5,23.0626604244448,#6b6b6b
295,0.000182,3,2,5,18.249668885536508,#6e6e6e
302,0.000103,1,4,5,12.735568257100576,#727272
283,0.000158,1,0,1,16.714793528209434,#707070
296,0.000133,1,2,3,14.999536055771733,#717171
1178,0.000128,1,2,3,14.639545810903515,#717171
290,0.000239,2,1,3,21.56564352455313,#6c6c6c
288,0.000297,1,0,1,24.590124646255656,#6a6a6a
336,0.000261,2,2,4,22.74805681184243,#6b6b6b
4435,0.000165,1,4,5,17.17269360034772,#6f6f6f
292,0.000136,2,1,3,15.212609940615039,#717171
291,0.000209,1,0,1,19.871111006625867,#6d6d6d
293,0.000155,1,0,1,16.515761823530525,#707070
300,0.000094,0,2,2,12,#737373
294,0.000133,1,0,1,14.999536055771733,#717171
297,0.00029,3,0,3,24.24017204011931,#6a6a6a
340,0.000207,1,3,4,19.754368044230688,#6d6d6d
343,0.000094,0,2,2,12,#737373
301,0.000116,1,0,1,13.748783606650441,#727272
307,0.000094,0,1,1,12,#737373
303,0.000189,2,0,2,18.67988652940294,#6e6e6e
304,0.000122,1,0,1,14.199095341257646,#717171
323,0.000094,0,1,1,12,#737373
353,0.000383,4,2,6,28.621200567431316,#676767
309,0.000483,3,0,3,32.82402693852907,#646464
358,0.000094,0,1,1,12,#737373
4431,0.000173,1,1,2,17.685431661066666,#6f6f6f
315,0.000149,2,1,3,16.112424734781012,#707070
326,0.000173,1,1,2,17.685431661066666,#6f6f6f
356,0.000094,0,2,2,12,#737373
317,0.000271,2,0,2,23.270631146211333,#6b6b6b
1119,0.000319,3,3,6,25.666498776595375,#696969
320,0.000191,1,1,2,18.801482814356014,#6e6e6e
4341,0.000161,2,1,3,16.912131765928624,#6f6f6f
324,0.00012,1,0,1,14.050122216323361,#717171
4428,0.000094,0,1,1,12,#737373
328,0.000094,0,1,1,12,#737373
379,0.000094,0,1,1,12,#737373
357,0.000173,1,1,2,17.685431661066666,#6f6f6f
331,0.000232,2,0,2,21.179240350145598,#6c6c6c
380,0.000094,0,1,1,12,#737373
332,0.000324,3,0,3,25.906420483962002,#696969
352,0.000094,0,4,4,12,#737373
373,0.000094,0,1,1,12,#737373
338,0.000173,1,1,2,17.685431661066666,#6f6f6f
339,0.000094,0,1,1,12,#737373
341,0.000133,1,1,2,14.999536055771733,#717171
347,0.000113,1,0,1,13.5196994710513,#727272
348,0.000113,1,0,1,13.5196994710513,#727272
349,0.000131,1,0,1,14.856283440227312,#717171
374,0.000094,0,1,1,12,#737373
4425,0.000094,0,1,1,12,#737373
4426,0.000173,1,1,2,17.685431661066666,#6f6f6f
377,0.000094,0,1,1,12,#737373
359,0.00014,1,0,1,15.493445725621832,#707070
375,0.000113,1,0,1,13.5196994710513,#727272
384,0.001275,3,1,4,57.578438444839605,#545454
383,0.001612,6,0,6,65.81730121054184,#4e4e4e
429,0.000173,2,1,3,17.685431661066666,#6f6f6f
445,0.000094,0,2,2,12,#737373
454,0.000184,2,1,3,18.373336658075203,#6e6e6e
455,0.00012,1,2,3,14.050122216323361,#717171
462,0.000094,0,2,2,12,#737373
393,0.00125,4,1,5,56.93022410010779,#545454
426,0.000326,3,3,6,26.00192217315449,#696969
447,0.000094,0,3,3,12,#737373
386,0.000438,5,1,6,30.986642003947352,#656565
385,0.000466,1,0,1,32.13934967801786,#656565
387,0.000094,0,1,1,12,#737373
446,0.000094,0,2,2,12,#737373
2307,0.000187,1,1,2,18.557709820386023,#6e6e6e
4941,0.000094,0,3,3,12,#737373
430,0.000191,2,3,5,18.801482814356014,#6e6e6e
388,0.000148,1,0,1,16.044496277075513,#707070
437,0.000094,0,2,2,12,#737373
389,0.0002,2,0,2,19.341713958828393,#6e6e6e
2282,0.000394,6,5,11,29.105935495221868,#676767
391,0.000911,4,1,5,47.477225108464765,#5a5a5a
390,0.000868,1,0,1,46.17193063631264,#5b5b5b
392,0.000369,4,1,5,27.995108790386844,#676767
394,0.000224,2,1,3,20.731153739353275,#6d6d6d
409,0.000222,1,1,2,20.61801225297066,#6d6d6d
423,0.000148,1,1,2,16.044496277075513,#707070
402,0.000367,5,2,7,27.9048006397121,#686868
406,0.000094,0,2,2,12,#737373
425,0.000186,1,3,4,18.496400996337503,#6e6e6e
436,0.000094,0,3,3,12,#737373
395,0.000331,4,1,5,26.23952956349499,#696969
396,0.000829,7,1,8,44.96265765791446,#5c5c5c
2223,0.00051,3,3,6,33.889550727488995,#636363
442,0.000173,1,2,3,17.685431661066666,#6f6f6f
457,0.000133,1,2,3,14.999536055771733,#717171
419,0.000177,2,1,3,17.937795520999256,#6f6f6f
2213,0.000094,0,3,3,12,#737373
2393,0.00012,1,3,4,14.050122216323361,#717171
397,0.000094,0,1,1,12,#737373
398,0.000094,0,1,1,12,#737373
399,0.000094,0,1,1,12,#737373
400,0.000094,0,1,1,12,#737373
420,0.000246,3,1,4,21.94698647096437,#6c6c6c
2231,0.000204,3,1,4,19.57829755448963,#6d6d6d
2283,0.00012,1,3,4,14.050122216323361,#717171
401,0.00025,1,0,1,22.162705238099072,#6c6c6c
403,0.000094,0,1,1,12,#737373
411,0.000172,1,2,3,17.621931704978525,#6f6f6f
435,0.00016,2,2,4,16.846537660321623,#6f6f6f
439,0.000094,0,3,3,12,#737373
405,0.000358,4,1,5,27.495644279994334,#686868
404,0.000398,1,0,1,29.28068923771282,#676767
431,0.000302,3,2,5,24.8378228436656,#6a6a6a
460,0.000094,0,2,2,12,#737373
408,0.000441,3,1,4,31.111702006160403,#656565
407,0.000469,1,0,1,32.26098175897728,#656565
451,0.000296,2,1,3,24.540360432916078,#6a6a6a
456,0.000133,1,2,3,14.999536055771733,#717171
410,0.000167,1,0,1,17.301908082944657,#6f6f6f
1216,0.000185,1,2,3,18.434943664037807,#6e6e6e
473,0.000094,0,2,2,12,#737373
412,0.000247,2,0,2,22.0010632357656,#6c6c6c
1248,0.000133,1,1,2,14.999536055771733,#717171
414,0.000146,1,1,2,15.908016751672154,#707070
413,0.000481,7,0,7,32.74404587870512,#646464
415,0.000094,0,1,1,12,#737373
452,0.000094,0,2,2,12,#737373
459,0.000094,0,3,3,12,#737373
464,0.00012,1,2,3,14.050122216323361,#717171
468,0.000094,0,3,3,12,#737373
417,0.000094,0,1,1,12,#737373
416,0.000395,5,0,5,29.149698491158492,#676767
444,0.000094,0,2,2,12,#737373
450,0.00012,1,1,2,14.050122216323361,#717171
469,0.000094,0,3,3,12,#737373
421,0.000094,0,3,3,12,#737373
418,0.00012,1,0,1,14.050122216323361,#717171
422,0.000256,3,0,3,22.483392551881522,#6b6b6b
1424,0.000133,1,2,3,14.999536055771733,#717171
1784,0.000094,0,1,1,12,#737373
424,0.000331,3,0,3,26.23952956349499,#696969
443,0.000171,2,1,3,17.5582653966192,#6f6f6f
427,0.000196,1,1,2,19.102991324867094,#6e6e6e
3987,0.000094,0,2,2,12,#737373
1125,0.00012,1,1,2,14.050122216323361,#717171
428,0.00016,2,0,2,16.846537660321623,#6f6f6f
470,0.000094,0,2,2,12,#737373
441,0.000167,1,2,3,17.301908082944657,#6f6f6f
432,0.00012,1,1,2,14.050122216323361,#717171
433,0.000094,0,1,1,12,#737373
472,0.000094,0,3,3,12,#737373
434,0.000161,1,0,1,16.912131765928624,#6f6f6f
461,0.000094,0,2,2,12,#737373
1297,0.000094,0,3,3,12,#737373
438,0.000186,3,0,3,18.496400996337503,#6e6e6e
440,0.000165,1,0,1,17.17269360034772,#6f6f6f
466,0.000094,0,1,1,12,#737373
449,0.000173,2,1,3,17.685431661066666,#6f6f6f
448,0.000241,1,0,1,21.675105650777578,#6c6c6c
465,0.000094,0,2,2,12,#737373
467,0.000094,0,2,2,12,#737373
453,0.000207,1,1,2,19.754368044230688,#6d6d6d
463,0.000133,1,1,2,14.999536055771733,#717171
458,0.000133,1,0,1,14.999536055771733,#717171
471,0.00012,1,0,1,14.050122216323361,#717171
481,0.000419,2,2,4,30.18546759115748,#666666
474,0.000298,2,0,2,24.63981351619035,#6a6a6a
4173,0.000094,0,3,3,12,#737373
4113,0.000447,1,1,2,31.360678985109885,#656565
475,0.000492,2,0,2,33.182111896248074,#646464
477,0.000275,2,1,3,23.477225028974956,#6b6b6b
476,0.000327,1,0,1,26.049574136619064,#696969
480,0.000125,1,2,3,14.420509920674892,#717171
484,0.000302,3,2,5,24.8378228436656,#6a6a6a
479,0.000325,2,1,3,25.954204386893895,#696969
478,0.000549,3,0,3,35.384812163377326,#626262
492,0.000165,2,1,3,17.17269360034772,#6f6f6f
498,0.000094,0,2,2,12,#737373
493,0.000112,1,3,4,13.442731432222969,#727272
491,0.000094,0,2,2,12,#737373
4111,0.000336,5,1,6,26.475527200275646,#696969
485,0.000326,4,2,6,26.00192217315449,#696969
482,0.000423,4,0,4,30.355472803492997,#666666
489,0.000094,0,2,2,12,#737373
494,0.000094,0,2,2,12,#737373
495,0.000131,1,1,2,14.856283440227312,#717171
483,0.000297,2,0,2,24.590124646255656,#6a6a6a
3769,0.000177,1,2,3,17.937795520999256,#6f6f6f
486,0.000133,1,1,2,14.999536055771733,#717171
497,0.000094,0,2,2,12,#737373
487,0.000133,1,0,1,14.999536055771733,#717171
1183,0.000119,1,1,2,13.975216770645698,#727272
488,0.00027,2,0,2,23.218768698136756,#6b6b6b
1201,0.000267,1,3,4,23.0626604244448,#6b6b6b
2426,0.001123,2,1,3,53.54297777630235,#565656
490,0.001977,11,0,11,73.90522008811512,#494949
2542,0.000697,11,2,13,40.66610263142369,#5f5f5f
2543,0.000194,2,4,6,18.982808118734695,#6e6e6e
2548,0.000411,4,5,9,29.843251162892585,#666666
2680,0.000263,1,2,3,22.85328285153254,#6b6b6b
2799,0.000388,3,3,6,28.842300770516935,#676767
2832,0.000173,1,2,3,17.685431661066666,#6f6f6f
2834,0.000094,0,3,3,12,#737373
2835,0.000094,0,3,3,12,#737373
2836,0.000094,0,3,3,12,#737373
2949,0.000173,1,1,2,17.685431661066666,#6f6f6f
501,0.000211,3,1,4,19.987352319632762,#6d6d6d
500,0.000273,1,0,1,23.374098358988334,#6b6b6b
549,0.000094,0,2,2,12,#737373
570,0.000177,1,4,5,17.937795520999256,#6f6f6f
573,0.000094,0,2,2,12,#737373
504,0.000866,3,2,5,46.110519152969914,#5b5b5b
502,0.000461,1,0,1,31.935843724487967,#656565
503,0.000461,1,0,1,31.935843724487967,#656565
523,0.000712,3,1,4,41.17178555251307,#5e5e5e
556,0.00012,1,2,3,14.050122216323361,#717171
564,0.000272,3,2,5,23.32240754705169,#6b6b6b
548,0.000272,4,3,7,23.32240754705169,#6b6b6b
505,0.000187,2,0,2,18.557709820386023,#6e6e6e
551,0.000094,0,5,5,12,#737373
539,0.000757,5,2,7,42.66076485691046,#5d5d5d
506,0.000616,3,0,3,37.84617794545803,#616161
546,0.000409,4,2,6,29.757229929753784,#666666
565,0.000094,0,3,3,12,#737373
507,0.000616,3,0,3,37.84617794545803,#616161
566,0.000094,0,3,3,12,#737373
508,0.000147,2,0,2,15.97636096389552,#707070
545,0.000094,0,3,3,12,#737373
509,0.000279,3,0,3,23.682471018741992,#6b6b6b
571,0.000094,0,1,1,12,#737373
572,0.000094,0,1,1,12,#737373
561,0.000094,0,4,4,12,#737373
510,0.000113,1,0,1,13.5196994710513,#727272
512,0.000094,0,1,1,12,#737373
511,0.000491,6,0,6,33.14247108015606,#646464
513,0.000094,0,1,1,12,#737373
534,0.000171,2,1,3,17.5582653966192,#6f6f6f
538,0.000109,1,2,3,13.209951757949934,#727272
550,0.000109,1,3,4,13.209951757949934,#727272
4458,0.000451,5,13,18,31.525828840546055,#656565
514,0.000123,1,0,1,14.27316966065317,#717171
519,0.000126,1,1,2,14.493782114686502,#717171
515,0.000201,1,0,1,19.40105797672826,#6e6e6e
520,0.000153,1,4,5,16.382109723928565,#707070
516,0.000126,1,0,1,14.493782114686502,#717171
517,0.000126,1,0,1,14.493782114686502,#717171
518,0.000336,2,0,2,26.475527200275646,#696969
3982,0.000247,2,1,3,22.0010632357656,#6c6c6c
2312,0.00014,2,2,4,15.493445725621832,#707070
521,0.000431,5,0,5,30.693327305825065,#666666
828,0.000404,1,2,3,29.541344831237414,#666666
832,0.000094,0,2,2,12,#737373
524,0.000303,1,1,2,24.887140432028936,#6a6a6a
525,0.000167,1,1,2,17.301908082944657,#6f6f6f
532,0.000515,6,2,8,34.0840585220959,#636363
528,0.000247,2,1,3,22.0010632357656,#6c6c6c
530,0.000173,1,2,3,17.685431661066666,#6f6f6f
527,0.000094,0,1,1,12,#737373
526,0.000505,3,0,3,33.6941828976396,#646464
4145,0.000133,1,1,2,14.999536055771733,#717171
529,0.000094,0,1,1,12,#737373
531,0.000094,0,1,1,12,#737373
533,0.000131,1,1,2,14.856283440227312,#717171
568,0.000094,0,3,3,12,#737373
536,0.000346,2,1,3,26.942830456588574,#686868
535,0.000507,3,0,3,33.772434019112126,#636363
559,0.000094,0,2,2,12,#737373
574,0.000094,0,1,1,12,#737373
537,0.000094,0,1,1,12,#737373
557,0.000203,2,1,3,19.51934882871322,#6d6d6d
540,0.000162,1,1,2,16.977542788511858,#6f6f6f
541,0.000162,1,1,2,16.977542788511858,#6f6f6f
542,0.000125,1,1,2,14.420509920674892,#717171
543,0.000166,3,1,4,17.237388412297367,#6f6f6f
544,0.000166,3,1,4,17.237388412297367,#6f6f6f
569,0.000161,2,2,4,16.912131765928624,#6f6f6f
553,0.000113,1,1,2,13.5196994710513,#727272
554,0.000113,1,1,2,13.5196994710513,#727272
558,0.000196,1,2,3,19.102991324867094,#6e6e6e
547,0.000191,2,0,2,18.801482814356014,#6e6e6e
555,0.000094,0,4,4,12,#737373
552,0.000113,1,1,2,13.5196994710513,#727272
563,0.000094,0,3,3,12,#737373
562,0.00012,1,1,2,14.050122216323361,#717171
560,0.000113,1,0,1,13.5196994710513,#727272
1481,0.000094,0,1,1,12,#737373
1482,0.000094,0,1,1,12,#737373
4211,0.000094,0,4,4,12,#737373
567,0.00012,1,0,1,14.050122216323361,#717171
4164,0.000295,4,3,7,24.490520506808657,#6a6a6a
657,0.000198,2,4,6,19.222623922752323,#6e6e6e
575,0.000374,4,0,4,28.21992043253382,#676767
659,0.000094,0,1,1,12,#737373
660,0.000094,0,1,1,12,#737373
730,0.000094,0,1,1,12,#737373
582,0.001498,4,1,5,63.12565615725625,#505050
576,0.00152,3,0,3,63.65208921774278,#505050
625,0.000094,0,1,1,12,#737373
640,0.000173,1,2,3,17.685431661066666,#6f6f6f
578,0.000298,2,1,3,24.63981351619035,#6a6a6a
577,0.000346,1,0,1,26.942830456588574,#686868
594,0.000385,4,2,6,28.709795603215216,#676767
610,0.000143,1,3,4,15.701709764920519,#707070
664,0.000094,0,2,2,12,#737373
579,0.000158,2,0,2,16.714793528209434,#707070
702,0.000145,1,5,6,15.839461562490118,#707070
720,0.000185,2,4,6,18.434943664037807,#6e6e6e
580,0.000144,2,0,2,15.770693283269225,#707070
725,0.000124,1,9,10,14.346973467931484,#717171
585,0.00022,1,2,3,20.50441114623677,#6d6d6d
581,0.000227,2,0,2,20.900017136346257,#6c6c6c
626,0.000094,0,2,2,12,#737373
583,0.000094,0,1,1,12,#737373
584,0.00087,5,1,6,46.233278477085314,#5b5b5b
612,0.000455,3,1,4,31.69032086435834,#656565
645,0.000234,2,1,3,21.290170301890548,#6c6c6c
652,0.000269,3,1,4,23.166819740335022,#6b6b6b
667,0.000268,3,1,4,23.114783806097357,#6b6b6b
672,0.000253,2,2,4,22.323476700598142,#6b6b6b
680,0.00042,5,3,8,30.228037116296132,#666666
614,0.000298,3,2,5,24.63981351619035,#6a6a6a
587,0.000426,5,1,6,30.48250242520127,#666666
586,0.000456,1,0,1,31.73134206884572,#656565
618,0.000119,1,2,3,13.975216770645698,#727272
624,0.000232,3,2,5,21.179240350145598,#6c6c6c
669,0.000094,0,2,2,12,#737373
679,0.000151,1,2,3,16.24766909105304,#707070
703,0.000094,0,1,1,12,#737373
597,0.000613,7,2,9,37.73862685704638,#616161
588,0.000354,1,0,1,27.31231277408949,#686868
590,0.000094,0,1,1,12,#737373
589,0.000585,4,0,4,36.723150329799296,#616161
591,0.000094,0,1,1,12,#737373
692,0.000398,4,2,6,29.28068923771282,#676767
593,0.000094,0,1,1,12,#737373
592,0.000504,3,0,3,33.65500504372394,#646464
630,0.000167,1,2,3,17.301908082944657,#6f6f6f
595,0.000094,0,1,1,12,#737373
596,0.000094,0,1,1,12,#737373
628,0.000124,1,2,3,14.346973467931484,#717171
705,0.000094,0,1,1,12,#737373
598,0.000094,0,1,1,12,#737373
599,0.000094,0,1,1,12,#737373
600,0.000094,0,1,1,12,#737373
601,0.000094,0,1,1,12,#737373
602,0.000094,0,1,1,12,#737373
620,0.000094,0,1,1,12,#737373
604,0.000442,4,1,5,31.153303542073253,#656565
603,0.000469,1,0,1,32.26098175897728,#656565
605,0.000236,2,1,3,21.40067441307267,#6c6c6c
606,0.000094,0,1,1,12,#737373
691,0.000094,0,3,3,12,#737373
658,0.000181,2,5,7,18.18760570927212,#6e6e6e
666,0.000263,1,2,3,22.85328285153254,#6b6b6b
607,0.000134,1,0,1,15.070798746414253,#717171
609,0.000307,4,1,5,25.083682362465577,#6a6a6a
608,0.000354,1,0,1,27.31231277408949,#686868
611,0.000094,0,1,1,12,#737373
662,0.00012,1,2,3,14.050122216323361,#717171
722,0.000173,1,3,4,17.685431661066666,#6f6f6f
613,0.00022,1,1,2,20.50441114623677,#6d6d6d
700,0.000118,1,1,2,13.900027528737976,#727272
619,0.000133,1,1,2,14.999536055771733,#717171
636,0.00012,1,2,3,14.050122216323361,#717171
676,0.000094,0,2,2,12,#737373
616,0.000165,2,1,3,17.17269360034772,#6f6f6f
615,0.000233,1,0,1,21.234758886801874,#6c6c6c
639,0.00021,4,3,7,19.929293935525752,#6d6d6d
617,0.000144,1,0,1,15.770693283269225,#707070
668,0.00012,1,4,5,14.050122216323361,#717171
622,0.000147,2,1,3,15.97636096389552,#707070
621,0.000218,1,0,1,20.390344347943245,#6d6d6d
653,0.000125,2,4,6,14.420509920674892,#717171
736,0.000094,0,3,3,12,#737373
623,0.000192,1,0,1,18.862066054200255,#6e6e6e
655,0.000171,2,2,4,17.5582653966192,#6f6f6f
708,0.000094,0,2,2,12,#737373
627,0.000146,1,0,1,15.908016751672154,#707070
629,0.000165,1,0,1,17.17269360034772,#6f6f6f
696,0.000173,1,2,3,17.685431661066666,#6f6f6f
632,0.000287,5,1,6,24.089030084755148,#6a6a6a
631,0.000338,1,0,1,26.56948332138532,#686868
634,0.000105,1,2,3,12.895045046072177,#727272
689,0.000133,1,3,4,14.999536055771733,#717171
718,0.000094,0,3,3,12,#737373
633,0.000138,1,0,1,15.353485735564822,#717171
635,0.000145,1,0,1,15.839461562490118,#707070
648,0.000094,0,3,3,12,#737373
671,0.00025,2,1,3,22.162705238099072,#6c6c6c
637,0.000502,4,0,4,33.57654424733758,#646464
709,0.000173,1,2,3,17.685431661066666,#6f6f6f
713,0.000173,1,3,4,17.685431661066666,#6f6f6f
728,0.000173,1,2,3,17.685431661066666,#6f6f6f
638,0.000153,1,0,1,16.382109723928565,#707070
681,0.000204,4,3,7,19.57829755448963,#6d6d6d
685,0.000094,0,4,4,12,#737373
641,0.000094,0,1,1,12,#737373
642,0.000124,1,0,1,14.346973467931484,#717171
644,0.000147,2,1,3,15.97636096389552,#707070
643,0.000218,1,0,1,20.390344347943245,#6d6d6d
687,0.000094,0,3,3,12,#737373
646,0.000094,0,1,1,12,#737373
704,0.000143,1,2,3,15.701709764920519,#707070
647,0.00012,1,0,1,14.050122216323361,#717171
650,0.000105,1,1,2,12.895045046072177,#727272
649,0.000183,1,0,1,18.311578797501046,#6e6e6e
651,0.00012,1,0,1,14.050122216323361,#717171
726,0.000212,1,6,7,20.045287013917818,#6d6d6d
654,0.000166,1,0,1,17.237388412297367,#6f6f6f
656,0.000124,1,0,1,14.346973467931484,#717171
712,0.000143,1,2,3,15.701709764920519,#707070
738,0.000094,0,3,3,12,#737373
661,0.000145,1,0,1,15.839461562490118,#707070
663,0.000133,1,0,1,14.999536055771733,#717171
665,0.000205,1,0,1,19.63711638898998,#6d6d6d
670,0.000154,1,0,1,16.449033409962986,#707070
673,0.000094,0,1,1,12,#737373
674,0.000094,0,1,1,12,#737373
675,0.000158,2,0,2,16.714793528209434,#707070
677,0.000144,2,0,2,15.770693283269225,#707070
678,0.000158,1,0,1,16.714793528209434,#707070
682,0.000094,0,1,1,12,#737373
683,0.000094,0,1,1,12,#737373
693,0.000094,0,1,1,12,#737373
684,0.000113,1,0,1,13.5196994710513,#727272
686,0.00012,1,0,1,14.050122216323361,#717171
688,0.000131,1,0,1,14.856283440227312,#717171
732,0.000094,0,2,2,12,#737373
690,0.00012,1,0,1,14.050122216323361,#717171
694,0.000203,2,1,3,19.51934882871322,#6d6d6d
695,0.000094,0,1,1,12,#737373
697,0.000094,0,1,1,12,#737373
699,0.000094,0,1,1,12,#737373
698,0.000247,2,0,2,22.0010632357656,#6c6c6c
701,0.000118,1,0,1,13.900027528737976,#727272
734,0.00012,1,2,3,14.050122216323361,#717171
707,0.000094,0,1,1,12,#737373
706,0.000247,2,0,2,22.0010632357656,#6c6c6c
710,0.000094,0,1,1,12,#737373
711,0.000154,1,0,1,16.449033409962986,#707070
714,0.000094,0,1,1,12,#737373
716,0.000133,1,1,2,14.999536055771733,#717171
715,0.000206,1,0,1,19.695806249957098,#6d6d6d
717,0.00012,1,0,1,14.050122216323361,#717171
719,0.000133,1,0,1,14.999536055771733,#717171
727,0.000094,0,1,1,12,#737373
721,0.000143,1,0,1,15.701709764920519,#707070
723,0.000094,0,1,1,12,#737373
724,0.000105,1,0,1,12.895045046072177,#727272
3781,0.000418,4,3,7,30.14285232234559,#666666
729,0.000094,0,1,1,12,#737373
731,0.000133,1,0,1,14.999536055771733,#717171
733,0.000145,1,0,1,15.839461562490118,#707070
735,0.00012,1,0,1,14.050122216323361,#717171
737,0.00012,1,0,1,14.050122216323361,#717171
740,0.000904,4,1,5,47.26665540755745,#5a5a5a
739,0.001313,3,0,3,58.55287031205852,#535353
749,0.000306,2,1,3,25.034655451212537,#6a6a6a
763,0.000226,3,1,4,20.843841544046825,#6d6d6d
748,0.000505,4,1,5,33.6941828976396,#646464
750,0.0005,3,2,5,33.49794265755702,#646464
757,0.000565,2,4,6,35.984358855581476,#626262
815,0.000173,1,3,4,17.685431661066666,#6f6f6f
744,0.000453,4,2,6,31.608156554086808,#656565
741,0.000286,1,0,1,24.03849160370686,#6a6a6a
743,0.000507,5,1,6,33.772434019112126,#636363
742,0.001297,4,0,4,58.144151007970166,#535353
759,0.000309,3,1,4,25.18152108960815,#696969
762,0.0004,3,3,6,29.367769677189468,#676767
779,0.000466,2,1,3,32.13934967801786,#656565
745,0.000094,0,1,1,12,#737373
760,0.00012,1,2,3,14.050122216323361,#717171
777,0.000133,1,2,3,14.999536055771733,#717171
804,0.00012,1,3,4,14.050122216323361,#717171
746,0.000094,0,1,1,12,#737373
802,0.000196,1,1,2,19.102991324867094,#6e6e6e
1230,0.000152,2,2,4,16.314988912055327,#707070
780,0.000554,6,2,8,35.573005228277026,#626262
747,0.000329,1,0,1,26.14468175968276,#696969
751,0.000094,0,1,1,12,#737373
775,0.000094,0,1,1,12,#737373
805,0.000094,0,2,2,12,#737373
752,0.000203,1,1,2,19.51934882871322,#6d6d6d
753,0.000128,1,1,2,14.639545810903515,#717171
776,0.000208,2,1,3,19.812802667928878,#6d6d6d
2413,0.000128,1,1,2,14.639545810903515,#717171
2414,0.000164,1,4,5,17.10782210585562,#6f6f6f
764,0.000462,2,1,3,31.976624070929397,#656565
754,0.000768,3,0,3,43.0186266501126,#5d5d5d
783,0.000593,2,2,4,37.01547697698377,#616161
803,0.000213,2,6,8,20.103098863481684,#6d6d6d
755,0.000214,1,0,1,20.160788703714612,#6d6d6d
756,0.000349,2,0,2,27.081832310819312,#686868
787,0.000159,2,1,3,16.78075881014393,#6f6f6f
758,0.000514,4,1,5,34.04522518194326,#636363
791,0.000124,1,3,4,14.346973467931484,#717171
812,0.0002,1,1,2,19.341713958828393,#6e6e6e
813,0.0002,1,1,2,19.341713958828393,#6e6e6e
823,0.000094,0,2,2,12,#737373
824,0.000094,0,2,2,12,#737373
778,0.00012,1,2,3,14.050122216323361,#717171
814,0.000094,0,3,3,12,#737373
761,0.000207,1,0,1,19.754368044230688,#6d6d6d
789,0.000094,0,4,4,12,#737373
774,0.000387,2,1,3,28.79818377446482,#676767
820,0.000094,0,2,2,12,#737373
766,0.000124,1,1,2,14.346973467931484,#717171
765,0.000199,1,0,1,19.282236265877913,#6e6e6e
771,0.000249,3,2,5,22.108922047173674,#6c6c6c
767,0.000199,1,0,1,19.282236265877913,#6e6e6e
772,0.000173,2,3,5,17.685431661066666,#6f6f6f
768,0.000143,1,0,1,15.701709764920519,#707070
769,0.000143,1,0,1,15.701709764920519,#707070
770,0.000381,3,0,3,28.532397098919894,#676767
785,0.00012,1,1,2,14.050122216323361,#717171
797,0.000094,0,1,1,12,#737373
773,0.000094,0,1,1,12,#737373
786,0.000094,0,3,3,12,#737373
781,0.000094,0,2,2,12,#737373
817,0.000298,1,1,2,24.63981351619035,#6a6a6a
4928,0.000207,1,2,3,19.754368044230688,#6d6d6d
2417,0.000094,0,2,2,12,#737373
795,0.000415,3,1,4,30.0147304615367,#666666
784,0.000094,0,1,1,12,#737373
799,0.000094,0,2,2,12,#737373
782,0.00015,2,0,2,16.180148347028588,#707070
4934,0.000094,0,3,3,12,#737373
800,0.000546,3,1,4,35.27152599801792,#626262
788,0.000113,1,0,1,13.5196994710513,#727272
2304,0.000142,1,2,3,15.632508821476176,#707070
790,0.000194,2,0,2,18.982808118734695,#6e6e6e
793,0.000435,3,1,4,30.861195944480013,#656565
792,0.000464,1,0,1,32.058065782639574,#656565
794,0.000128,1,1,2,14.639545810903515,#717171
811,0.000283,2,2,4,23.88639704795272,#6a6a6a
1214,0.000133,1,1,2,14.999536055771733,#717171
796,0.000094,0,1,1,12,#737373
808,0.000245,1,1,2,21.892810694385922,#6c6c6c
798,0.000133,1,0,1,14.999536055771733,#717171
801,0.000094,0,1,1,12,#737373
1257,0.000362,5,1,6,27.678056297441284,#686868
2207,0.00012,1,1,2,14.050122216323361,#717171
807,0.000094,0,2,2,12,#737373
821,0.000094,0,1,1,12,#737373
1402,0.000094,0,3,3,12,#737373
806,0.000133,1,0,1,14.999536055771733,#717171
809,0.000178,1,1,2,18.000484217107044,#6f6f6f
822,0.000198,1,2,3,19.222623922752323,#6e6e6e
810,0.000214,1,0,1,20.160788703714612,#6d6d6d
1124,0.000247,2,2,4,22.0010632357656,#6c6c6c
1227,0.000126,1,1,2,14.493782114686502,#717171
1228,0.000126,1,1,2,14.493782114686502,#717171
816,0.000094,0,1,1,12,#737373
818,0.000241,1,1,2,21.675105650777578,#6c6c6c
819,0.000173,2,1,3,17.685431661066666,#6f6f6f
4940,0.000094,0,2,2,12,#737373
826,0.000286,2,1,3,24.03849160370686,#6a6a6a
825,0.001187,2,0,2,55.27033622176786,#555555
844,0.001001,2,1,3,50.12249087961865,#585858
829,0.000203,3,1,4,19.51934882871322,#6d6d6d
4462,0.000094,0,4,4,12,#737373
827,0.000559,4,0,4,35.76043550850109,#626262
845,0.000173,2,1,3,17.685431661066666,#6f6f6f
858,0.000125,1,1,2,14.420509920674892,#717171
877,0.000094,0,2,2,12,#737373
837,0.000365,4,1,5,27.814270751789376,#686868
834,0.000094,0,2,2,12,#737373
836,0.000094,0,2,2,12,#737373
4444,0.000143,2,1,3,15.701709764920519,#707070
830,0.000215,1,0,1,20.218357360452792,#6d6d6d
831,0.001202,14,0,14,55.66907408256165,#555555
855,0.000225,2,3,5,20.787553985810852,#6d6d6d
867,0.000094,0,1,1,12,#737373
868,0.000094,0,1,1,12,#737373
869,0.000241,2,1,3,21.675105650777578,#6c6c6c
895,0.00016,2,3,5,16.846537660321623,#6f6f6f
903,0.000094,0,2,2,12,#737373
904,0.000094,0,1,1,12,#737373
905,0.000094,0,1,1,12,#737373
906,0.000094,0,1,1,12,#737373
910,0.000094,0,1,1,12,#737373
919,0.000094,0,1,1,12,#737373
920,0.000094,0,1,1,12,#737373
932,0.000094,0,1,1,12,#737373
833,0.000682,6,0,6,40.15549823647371,#5f5f5f
854,0.000642,6,3,9,38.76859825791353,#606060
862,0.000094,0,2,2,12,#737373
866,0.000094,0,1,1,12,#737373
874,0.00026,3,1,4,22.69530774034737,#6b6b6b
891,0.000094,0,3,3,12,#737373
835,0.000211,3,0,3,19.987352319632762,#6d6d6d
892,0.00012,1,2,3,14.050122216323361,#717171
896,0.000094,0,3,3,12,#737373
853,0.000094,0,3,3,12,#737373
871,0.000144,2,1,3,15.770693283269225,#707070
872,0.000109,1,1,2,13.209951757949934,#727272
839,0.000255,1,1,2,22.430181432297555,#6b6b6b
838,0.000337,2,0,2,26.52253662605617,#696969
840,0.00019,1,1,2,18.740756670053315,#6e6e6e
2351,0.000113,1,1,2,13.5196994710513,#727272
842,0.000109,1,1,2,13.209951757949934,#727272
841,0.000187,1,0,1,18.557709820386023,#6e6e6e
4179,0.000094,0,5,5,12,#737373
861,0.000094,0,2,2,12,#737373
843,0.000317,4,0,4,25.570056738071315,#696969
863,0.000094,0,2,2,12,#737373
4457,0.000123,1,1,2,14.27316966065317,#717171
846,0.001021,8,1,9,50.69558337238433,#585858
865,0.000094,0,2,2,12,#737373
847,0.00059,2,1,3,36.90606369527854,#616161
860,0.000094,0,3,3,12,#737373
870,0.000094,0,1,1,12,#737373
880,0.00012,1,1,2,14.050122216323361,#717171
884,0.000094,0,2,2,12,#737373
894,0.000094,0,3,3,12,#737373
900,0.000094,0,3,3,12,#737373
912,0.000147,2,1,3,15.97636096389552,#707070
848,0.000491,5,1,6,33.14247108015606,#646464
911,0.000094,0,1,1,12,#737373
879,0.000094,0,1,1,12,#737373
886,0.000094,0,1,1,12,#737373
887,0.000094,0,1,1,12,#737373
888,0.000094,0,1,1,12,#737373
889,0.000094,0,1,1,12,#737373
849,0.000396,4,0,4,29.193411658840844,#676767
907,0.000094,0,1,1,12,#737373
908,0.000094,0,1,1,12,#737373
909,0.000094,0,1,1,12,#737373
850,0.000355,2,0,2,27.358232671492853,#686868
898,0.000094,0,1,1,12,#737373
851,0.000275,1,0,1,23.477225028974956,#6b6b6b
852,0.000336,5,0,5,26.475527200275646,#696969
873,0.00012,1,1,2,14.050122216323361,#717171
902,0.000168,3,3,6,17.36625413094873,#6f6f6f
859,0.000318,4,1,5,25.61831187604224,#696969
864,0.000256,2,2,4,22.483392551881522,#6b6b6b
856,0.000123,1,1,2,14.27316966065317,#717171
882,0.000171,2,1,3,17.5582653966192,#6f6f6f
857,0.000338,3,0,3,26.56948332138532,#686868
893,0.00012,1,2,3,14.050122216323361,#717171
885,0.000112,1,3,4,13.442731432222969,#727272
881,0.00012,1,2,3,14.050122216323361,#717171
883,0.000133,1,3,4,14.999536055771733,#717171
921,0.000147,2,1,3,15.97636096389552,#707070
899,0.00012,1,1,2,14.050122216323361,#717171
928,0.000109,1,5,6,13.209951757949934,#727272
929,0.000094,0,5,5,12,#737373
930,0.000094,0,3,3,12,#737373
897,0.000094,0,2,2,12,#737373
901,0.000112,1,1,2,13.442731432222969,#727272
876,0.000165,2,1,3,17.17269360034772,#6f6f6f
875,0.000511,4,0,4,33.92852069846253,#636363
878,0.000206,4,1,5,19.695806249957098,#6d6d6d
931,0.000094,0,2,2,12,#737373
890,0.000157,2,0,2,16.648640101132177,#707070
917,0.000094,0,3,3,12,#737373
918,0.000094,0,3,3,12,#737373
913,0.00012,1,0,1,14.050122216323361,#717171
914,0.00012,1,0,1,14.050122216323361,#717171
915,0.00012,1,0,1,14.050122216323361,#717171
916,0.00012,1,0,1,14.050122216323361,#717171
926,0.000094,0,3,3,12,#737373
927,0.000094,0,3,3,12,#737373
922,0.00012,1,0,1,14.050122216323361,#717171
923,0.00012,1,0,1,14.050122216323361,#717171
924,0.00012,1,0,1,14.050122216323361,#717171
925,0.00012,1,0,1,14.050122216323361,#717171
1014,0.000094,0,3,3,12,#737373
933,0.0002,2,0,2,19.341713958828393,#6e6e6e
1053,0.000094,0,1,1,12,#737373
935,0.000161,1,1,2,16.912131765928624,#6f6f6f
934,0.000694,3,0,3,40.5643803980394,#5f5f5f
936,0.000467,1,1,2,32.179932751603054,#656565
969,0.000158,2,2,4,16.714793528209434,#707070
941,0.000439,3,1,4,31.028371377525648,#656565
938,0.000094,0,1,1,12,#737373
937,0.000352,4,0,4,27.2202975093119,#686868
954,0.000142,2,1,3,15.632508821476176,#707070
1010,0.000147,2,3,5,15.97636096389552,#707070
1050,0.000162,2,8,10,16.977542788511858,#6f6f6f
940,0.000247,3,1,4,22.0010632357656,#6c6c6c
939,0.000789,4,0,4,43.695472284703534,#5d5d5d
956,0.000261,3,1,4,22.74805681184243,#6b6b6b
961,0.00012,1,1,2,14.050122216323361,#717171
984,0.00019,2,1,3,18.740756670053315,#6e6e6e
1016,0.000173,1,2,3,17.685431661066666,#6f6f6f
1036,0.000094,0,2,2,12,#737373
1051,0.000094,0,2,2,12,#737373
942,0.000289,2,1,3,24.189869906310776,#6a6a6a
994,0.000173,1,2,3,17.685431661066666,#6f6f6f
946,0.000173,1,1,2,17.685431661066666,#6f6f6f
959,0.000114,1,2,3,13.596361604606898,#727272
944,0.000292,3,1,4,24.340542711983574,#6a6a6a
943,0.000612,4,0,4,37.70272388404443,#616161
1003,0.000133,1,1,2,14.999536055771733,#717171
1005,0.000482,8,3,11,32.78405507641063,#646464
1028,0.000094,0,4,4,12,#737373
945,0.000154,2,1,3,16.449033409962986,#707070
995,0.000113,1,2,3,13.5196994710513,#727272
1006,0.00012,1,5,6,14.050122216323361,#717171
1058,0.000094,0,2,2,12,#737373
947,0.000094,0,1,1,12,#737373
949,0.000444,3,1,4,31.23637975340296,#656565
948,0.001344,5,0,5,59.33843787894212,#525252
950,0.00074,3,1,4,42.10306976405023,#5e5e5e
964,0.00021,1,1,2,19.929293935525752,#6d6d6d
1047,0.000094,0,3,3,12,#737373
1048,0.000094,0,2,2,12,#737373
951,0.00048,3,2,5,32.70399923280961,#646464
962,0.000126,1,1,2,14.493782114686502,#717171
1043,0.000094,0,2,2,12,#737373
970,0.000457,2,1,3,31.77232281180942,#656565
1034,0.00019,1,3,4,18.740756670053315,#6e6e6e
971,0.000176,2,2,4,17.874947243038193,#6f6f6f
978,0.00023,1,1,2,21.067879224360784,#6c6c6c
1000,0.000136,1,1,2,15.212609940615039,#717171
953,0.000269,4,1,5,23.166819740335022,#6b6b6b
952,0.000608,5,0,5,37.55884727414517,#616161
975,0.000175,2,1,3,17.811938066790663,#6f6f6f
1023,0.000131,2,2,4,14.856283440227312,#717171
1024,0.000131,2,2,4,14.856283440227312,#717171
1056,0.000094,0,3,3,12,#737373
983,0.000094,0,2,2,12,#737373
1011,0.000094,0,3,3,12,#737373
973,0.000109,1,3,4,13.209951757949934,#727272
955,0.000133,1,0,1,14.999536055771733,#717171
957,0.000094,0,1,1,12,#737373
1015,0.000167,1,2,3,17.301908082944657,#6f6f6f
958,0.000194,3,0,3,18.982808118734695,#6e6e6e
993,0.000113,1,3,4,13.5196994710513,#727272
1049,0.000094,0,4,4,12,#737373
965,0.000254,3,1,4,22.37687632753905,#6b6b6b
960,0.000505,2,0,2,33.6941828976396,#646464
987,0.00023,2,1,3,21.067879224360784,#6c6c6c
991,0.00016,2,1,3,16.846537660321623,#6f6f6f
963,0.00035,3,0,3,27.12804667565457,#686868
1013,0.000094,0,2,2,12,#737373
1025,0.000136,1,1,2,15.212609940615039,#717171
966,0.000133,1,1,2,14.999536055771733,#717171
1021,0.000094,0,5,5,12,#737373
968,0.00014,2,1,3,15.493445725621832,#707070
967,0.000256,2,0,2,22.483392551881522,#6b6b6b
1026,0.000253,3,5,8,22.323476700598142,#6b6b6b
1057,0.000094,0,3,3,12,#737373
996,0.000339,1,1,2,26.61636755519475,#686868
1037,0.000094,0,2,2,12,#737373
972,0.000125,1,0,1,14.420509920674892,#717171
974,0.000302,3,0,3,24.8378228436656,#6a6a6a
1031,0.000229,2,2,4,21.012035273453705,#6c6c6c
1054,0.000094,0,2,2,12,#737373
976,0.000187,2,0,2,18.557709820386023,#6e6e6e
992,0.000277,3,1,4,23.580014741542964,#6b6b6b
977,0.000356,2,0,2,27.4040943973584,#686868
980,0.000133,1,1,2,14.999536055771733,#717171
4855,0.000094,0,2,2,12,#737373
982,0.000094,0,1,1,12,#737373
981,0.000271,3,0,3,23.270631146211333,#6b6b6b
985,0.000094,0,1,1,12,#737373
986,0.000297,3,0,3,24.590124646255656,#6a6a6a
1012,0.00016,2,1,3,16.846537660321623,#6f6f6f
1044,0.000094,0,3,3,12,#737373
988,0.000094,0,1,1,12,#737373
990,0.000167,1,0,1,17.301908082944657,#6f6f6f
998,0.000147,1,1,2,15.97636096389552,#707070
999,0.000094,0,1,1,12,#737373
1001,0.000289,1,1,2,24.189869906310776,#6a6a6a
1002,0.00023,1,1,2,21.067879224360784,#6c6c6c
1045,0.000094,0,2,2,12,#737373
1004,0.000129,2,0,2,14.712043210723964,#717171
1007,0.000094,0,1,1,12,#737373
1008,0.000094,0,1,1,12,#737373
1009,0.000094,0,1,1,12,#737373
1017,0.000094,0,1,1,12,#737373
1019,0.00024,3,1,4,21.620425898203866,#6c6c6c
1018,0.000436,2,0,2,30.903054430226412,#656565
1022,0.000163,3,1,4,17.042772364524353,#6f6f6f
1046,0.000113,1,3,4,13.5196994710513,#727272
1020,0.000109,1,0,1,13.209951757949934,#727272
1059,0.000094,0,4,4,12,#737373
1027,0.000094,0,1,1,12,#737373
1029,0.000174,1,0,1,17.748766657369394,#6f6f6f
1033,0.00012,1,1,2,14.050122216323361,#717171
1038,0.000094,0,1,1,12,#737373
1039,0.000094,0,1,1,12,#737373
1040,0.000094,0,1,1,12,#737373
4894,0.000094,0,2,2,12,#737373
1032,0.000122,1,1,2,14.199095341257646,#717171
4902,0.000094,0,3,3,12,#737373
1035,0.000113,1,1,2,13.5196994710513,#727272
1042,0.000094,0,1,1,12,#737373
1041,0.000226,3,0,3,20.843841544046825,#6d6d6d
1061,0.000131,1,1,2,14.856283440227312,#717171
1060,0.000692,5,0,5,40.49645561477645,#5f5f5f
1062,0.000131,1,1,2,14.856283440227312,#717171
1542,0.000348,2,1,3,27.03555831872816,#686868
2002,0.000094,0,2,2,12,#737373
2035,0.000094,0,2,2,12,#737373
1444,0.000133,1,3,4,14.999536055771733,#717171
1065,0.000282,2,1,3,23.835537796096794,#6a6a6a
1063,0.000809,5,0,5,44.3325896852099,#5c5c5c
1160,0.000173,2,1,3,17.685431661066666,#6f6f6f
1331,0.000133,1,1,2,14.999536055771733,#717171
1625,0.000207,1,1,2,19.754368044230688,#6d6d6d
1809,0.000094,0,2,2,12,#737373
1176,0.000133,1,2,3,14.999536055771733,#717171
1064,0.00015,1,0,1,16.180148347028588,#707070
1091,0.000459,6,4,10,31.85416342574387,#656565
1852,0.000094,0,2,2,12,#737373
1066,0.000213,3,0,3,20.103098863481684,#6d6d6d
1901,0.000094,0,2,2,12,#737373
2069,0.000094,0,2,2,12,#737373
1068,0.000182,1,1,2,18.249668885536508,#6e6e6e
1067,0.000751,3,0,3,42.46458111431075,#5e5e5e
1418,0.000525,3,1,4,34.47054204663135,#636363
1969,0.000133,1,2,3,14.999536055771733,#717171
1419,0.000313,5,3,8,25.376347528504994,#696969
1070,0.000239,2,1,3,21.56564352455313,#6c6c6c
1069,0.000791,7,0,7,43.75950855117366,#5d5d5d
1196,0.00012,1,1,2,14.050122216323361,#717171
1197,0.000094,0,3,3,12,#737373
1300,0.000167,2,2,4,17.301908082944657,#6f6f6f
1497,0.000094,0,2,2,12,#737373
1498,0.000094,0,2,2,12,#737373
1566,0.000253,2,1,3,22.323476700598142,#6b6b6b
1269,0.000113,1,2,3,13.5196994710513,#727272
1371,0.000343,4,3,7,26.803285186298606,#686868
1553,0.000094,0,2,2,12,#737373
1071,0.000411,3,0,3,29.843251162892585,#666666
1615,0.000207,1,1,2,19.754368044230688,#6d6d6d
2028,0.00012,1,1,2,14.050122216323361,#717171
1073,0.000171,2,1,3,17.5582653966192,#6f6f6f
1072,0.001813,7,0,7,70.36250423868584,#4b4b4b
1191,0.000224,3,2,5,20.731153739353275,#6d6d6d
1208,0.000339,2,1,3,26.61636755519475,#686868
1280,0.000315,3,1,4,25.473340498053965,#696969
1314,0.000235,2,1,3,21.345475258565315,#6c6c6c
1469,0.000094,0,2,2,12,#737373
1554,0.000804,8,1,9,44.17398112828648,#5c5c5c
1192,0.00012,1,2,3,14.050122216323361,#717171
1313,0.000153,2,5,7,16.382109723928565,#707070
1076,0.000094,0,2,2,12,#737373
1074,0.000494,3,0,3,33.26128491407656,#646464
1159,0.000617,5,2,7,37.88197590456045,#616161
1506,0.000466,5,4,9,32.13934967801786,#656565
1075,0.000301,3,0,3,24.78843171388773,#6a6a6a
1217,0.00015,1,1,2,16.180148347028588,#707070
1905,0.000094,0,2,2,12,#737373
1224,0.000855,9,3,12,45.771608793628786,#5b5b5b
1077,0.000336,1,0,1,26.475527200275646,#696969
1079,0.000094,0,1,1,12,#737373
1078,0.000342,5,0,5,26.756648147804192,#686868
1244,0.000239,4,2,6,21.56564352455313,#6c6c6c
1306,0.00012,1,4,5,14.050122216323361,#717171
1459,0.000094,0,5,5,12,#737373
1334,0.000515,7,4,11,34.0840585220959,#636363
1080,0.000243,2,0,2,21.78415975388338,#6c6c6c
1559,0.000094,0,2,2,12,#737373
1154,0.00012,1,1,2,14.050122216323361,#717171
1081,0.000349,3,0,3,27.081832310819312,#686868
1560,0.000133,1,1,2,14.999536055771733,#717171
1942,0.000094,0,2,2,12,#737373
1082,0.000512,4,0,4,33.96745636653713,#636363
1510,0.000133,1,2,3,14.999536055771733,#717171
1728,0.000094,0,2,2,12,#737373
1750,0.000094,0,1,1,12,#737373
1295,0.000094,0,1,1,12,#737373
1083,0.000304,3,0,3,24.93638483064867,#6a6a6a
1446,0.000242,2,4,6,21.729683399131453,#6c6c6c
1503,0.000094,0,1,1,12,#737373
1098,0.001125,7,1,8,53.597618106590176,#565656
1084,0.001292,2,0,2,58.015961530062626,#535353
1086,0.000346,3,1,4,26.942830456588574,#686868
1085,0.002235,6,0,6,79.22102475676252,#454545
1087,0.001558,5,1,6,64.55337296492027,#4f4f4f
1351,0.000167,1,1,2,17.301908082944657,#6f6f6f
1367,0.000358,3,1,4,27.495644279994334,#686868
1420,0.000094,0,2,2,12,#737373
1478,0.000173,2,4,6,17.685431661066666,#6f6f6f
1088,0.000218,2,2,4,20.390344347943245,#6d6d6d
1097,0.000147,2,2,4,15.97636096389552,#707070
1090,0.001059,7,1,8,51.77071709048557,#575757
1220,0.00033,1,1,2,26.19213799612306,#696969
1223,0.000178,1,1,2,18.000484217107044,#6f6f6f
1624,0.000094,0,2,2,12,#737373
1401,0.000094,0,3,3,12,#737373
1311,0.000396,5,1,6,29.193411658840844,#676767
1089,0.000522,3,0,3,34.35494752377393,#636363
1556,0.000094,0,2,2,12,#737373
1108,0.000224,2,1,3,20.731153739353275,#6d6d6d
1165,0.000396,4,1,5,29.193411658840844,#676767
1496,0.00012,1,2,3,14.050122216323361,#717171
1630,0.000207,1,1,2,19.754368044230688,#6d6d6d
1959,0.000094,0,2,2,12,#737373
2017,0.000173,1,2,3,17.685431661066666,#6f6f6f
1092,0.000113,1,1,2,13.5196994710513,#727272
1166,0.000518,6,4,10,34.20035541967408,#636363
1353,0.000313,3,4,7,25.376347528504994,#696969
1429,0.000094,0,3,3,12,#737373
1504,0.000094,0,2,2,12,#737373
1525,0.000094,0,3,3,12,#737373
1488,0.000094,0,4,4,12,#737373
1094,0.000349,2,1,3,27.081832310819312,#686868
1093,0.001204,4,0,4,55.72206953679146,#555555
1095,0.000831,5,1,6,45.025286307227645,#5c5c5c
2096,0.00016,2,2,4,16.846537660321623,#6f6f6f
2135,0.000094,0,2,2,12,#737373
1177,0.000267,3,1,4,23.0626604244448,#6b6b6b
1447,0.000133,1,4,5,14.999536055771733,#717171
1386,0.000309,3,1,4,25.18152108960815,#696969
2071,0.000253,2,1,3,22.323476700598142,#6b6b6b
2091,0.00012,1,1,2,14.050122216323361,#717171
2159,0.000253,2,2,4,22.323476700598142,#6b6b6b
1096,0.000309,3,0,3,25.18152108960815,#696969
1285,0.000133,1,1,2,14.999536055771733,#717171
2109,0.000094,0,2,2,12,#737373
1343,0.000094,0,3,3,12,#737373
1379,0.000094,0,3,3,12,#737373
1099,0.000203,1,1,2,19.51934882871322,#6d6d6d
1193,0.000558,1,1,2,35.72300999818396,#626262
1490,0.000094,0,2,2,12,#737373
1677,0.000094,0,3,3,12,#737373
1713,0.00028,2,1,3,23.7335752027898,#6a6a6a
1731,0.000094,0,2,2,12,#737373
1914,0.000094,0,2,2,12,#737373
1101,0.00017,2,1,3,17.494431323525504,#6f6f6f
1100,0.001192,6,0,6,55.40349945610741,#555555
1276,0.0009,5,1,6,47.14600038518087,#5a5a5a
1530,0.000325,5,4,9,25.954204386893895,#696969
2062,0.000094,0,2,2,12,#737373
2176,0.000094,0,2,2,12,#737373
2179,0.000094,0,2,2,12,#737373
1277,0.000133,1,2,3,14.999536055771733,#717171
2139,0.000094,0,4,4,12,#737373
1103,0.000309,2,1,3,25.18152108960815,#696969
1102,0.000913,5,0,5,47.53725402406988,#5a5a5a
1226,0.000308,1,2,3,25.13263746265548,#696969
1338,0.00025,1,2,3,22.162705238099072,#6c6c6c
1422,0.000133,1,4,5,14.999536055771733,#717171
1573,0.000343,2,1,3,26.803285186298606,#686868
1143,0.000339,2,2,4,26.61636755519475,#686868
1442,0.000253,4,3,7,22.323476700598142,#6b6b6b
1460,0.000806,9,1,10,44.237477666027445,#5c5c5c
1104,0.001303,6,0,6,58.297685202967095,#535353
1717,0.000196,1,1,2,19.102991324867094,#6e6e6e
1753,0.000133,1,1,2,14.999536055771733,#717171
2061,0.000113,1,1,2,13.5196994710513,#727272
2121,0.000128,1,1,2,14.639545810903515,#717171
1106,0.001496,9,1,10,63.077626628066554,#505050
1105,0.001994,5,0,5,74.26475118417953,#494949
1145,0.000466,2,1,3,32.13934967801786,#656565
1179,0.000094,0,1,1,12,#737373
1666,0.000133,1,1,2,14.999536055771733,#717171
1948,0.000094,0,2,2,12,#737373
1107,0.000205,3,1,4,19.63711638898998,#6d6d6d
1136,0.000292,3,1,4,24.340542711983574,#6a6a6a
1180,0.000094,0,1,1,12,#737373
1249,0.000415,1,1,2,30.0147304615367,#666666
1317,0.000168,2,1,3,17.36625413094873,#6f6f6f
1323,0.000426,5,2,7,30.48250242520127,#666666
1810,0.000094,0,2,2,12,#737373
1877,0.000094,0,2,2,12,#737373
1137,0.000094,0,2,2,12,#737373
1267,0.000135,2,4,6,15.141822520724293,#717171
1365,0.000153,2,3,5,16.382109723928565,#707070
1240,0.000094,0,1,1,12,#737373
1210,0.000269,3,1,4,23.166819740335022,#6b6b6b
1109,0.000453,3,0,3,31.608156554086808,#656565
1471,0.000173,2,2,4,17.685431661066666,#6f6f6f
1495,0.000133,1,2,3,14.999536055771733,#717171
1111,0.000109,1,1,2,13.209951757949934,#727272
1110,0.000187,1,0,1,18.557709820386023,#6e6e6e
1579,0.000173,1,2,3,17.685431661066666,#6f6f6f
1112,0.000372,2,0,2,28.130159060209138,#676767
1581,0.000241,1,1,2,21.675105650777578,#6c6c6c
1116,0.000439,4,1,5,31.028371377525648,#656565
1113,0.000466,1,0,1,32.13934967801786,#656565
1837,0.000133,1,1,2,14.999536055771733,#717171
1114,0.00032,2,0,2,25.714617749683157,#696969
1932,0.000133,1,1,2,14.999536055771733,#717171
1543,0.000262,1,1,2,22.800715014747656,#6b6b6b
1115,0.000486,3,0,3,32.943719628852016,#646464
1603,0.000133,1,1,2,14.999536055771733,#717171
1453,0.000133,1,2,3,14.999536055771733,#717171
1454,0.000133,1,2,3,14.999536055771733,#717171
1499,0.000226,4,1,5,20.843841544046825,#6d6d6d
1552,0.000094,0,2,2,12,#737373
1189,0.000146,1,2,3,15.908016751672154,#707070
1117,0.000802,6,0,6,44.110413472444264,#5c5c5c
1436,0.000186,1,3,4,18.496400996337503,#6e6e6e
1461,0.000173,2,5,7,17.685431661066666,#6f6f6f
1463,0.00044,1,3,4,31.070057997990283,#656565
1584,0.000471,6,1,7,32.34187538376585,#646464
2195,0.000094,0,2,2,12,#737373
1118,0.000224,2,0,2,20.731153739353275,#6d6d6d
1825,0.000094,0,2,2,12,#737373
4437,0.000168,2,1,3,17.36625413094873,#6f6f6f
1120,0.000173,2,0,2,17.685431661066666,#6f6f6f
1956,0.000094,0,2,2,12,#737373
1122,0.000367,2,1,3,27.9048006397121,#686868
1121,0.000405,1,0,1,29.58461761737899,#666666
1163,0.000179,1,2,3,18.06301462969796,#6f6f6f
1275,0.000465,1,2,3,32.0987273958043,#656565
1243,0.000382,4,2,6,28.57682498606312,#676767
1123,0.000298,3,0,3,24.63981351619035,#6a6a6a
1576,0.000133,1,1,2,14.999536055771733,#717171
2021,0.000094,0,2,2,12,#737373
1476,0.000094,0,3,3,12,#737373
1127,0.000384,1,1,2,28.665524040933125,#676767
1126,0.000579,2,0,2,36.5027230784917,#626262
1128,0.000187,2,1,3,18.557709820386023,#6e6e6e
1863,0.000342,1,1,2,26.756648147804192,#686868
1187,0.000133,1,1,2,14.999536055771733,#717171
1129,0.000338,2,0,2,26.56948332138532,#686868
1830,0.000094,0,2,2,12,#737373
1130,0.000173,2,0,2,17.685431661066666,#6f6f6f
1131,0.0005,4,0,4,33.49794265755702,#646464
1308,0.000598,2,3,5,37.197280445673044,#616161
1330,0.000094,0,3,3,12,#737373
2557,0.000113,1,2,3,13.5196994710513,#727272
1135,0.000244,2,1,3,21.838535319500465,#6c6c6c
1132,0.000578,3,0,3,36.46588545161213,#626262
1493,0.000094,0,2,2,12,#737373
1605,0.000279,3,1,4,23.682471018741992,#6b6b6b
1242,0.000694,4,1,5,40.5643803980394,#5f5f5f
1133,0.00118,3,0,3,55.08348288491245,#555555
1609,0.000371,3,1,4,28.085196944357673,#676767
1416,0.000133,1,6,7,14.999536055771733,#717171
1134,0.000208,3,0,3,19.812802667928878,#6d6d6d
1531,0.000094,0,5,5,12,#737373
1610,0.000094,0,1,1,12,#737373
1451,0.000252,3,3,6,22.26998200926203,#6c6c6c
1534,0.000094,0,1,1,12,#737373
1138,0.000094,0,1,1,12,#737373
1139,0.000094,0,1,1,12,#737373
1301,0.000094,0,2,2,12,#737373
1140,0.000609,8,0,8,37.5948562602,#616161
1332,0.000141,1,2,3,15.56308822919205,#707070
1345,0.000167,1,3,4,17.301908082944657,#6f6f6f
1361,0.000406,5,3,8,29.627842349289,#666666
1458,0.000133,1,2,3,14.999536055771733,#717171
1486,0.000094,0,3,3,12,#737373
1619,0.000133,1,1,2,14.999536055771733,#717171
1620,0.000133,1,2,3,14.999536055771733,#717171
1142,0.000224,2,1,3,20.731153739353275,#6d6d6d
1141,0.000284,1,0,1,23.937175492264057,#6a6a6a
1474,0.000213,2,2,4,20.103098863481684,#6d6d6d
1874,0.000094,0,2,2,12,#737373
1434,0.000116,1,1,2,13.748783606650441,#727272
1622,0.000517,2,3,5,34.16162354591827,#636363
1222,0.000133,1,1,2,14.999536055771733,#717171
1144,0.000207,1,0,1,19.754368044230688,#6d6d6d
1491,0.000391,3,1,4,28.97434569732119,#676767
1955,0.000094,0,2,2,12,#737373
1148,0.000267,3,2,5,23.0626604244448,#6b6b6b
1146,0.000207,1,0,1,19.754368044230688,#6d6d6d
1147,0.000583,5,0,5,36.64978810796188,#626262
1207,0.000094,0,2,2,12,#737373
2063,0.000133,1,1,2,14.999536055771733,#717171
2064,0.000133,1,1,2,14.999536055771733,#717171
1167,0.000215,2,2,4,20.218357360452792,#6d6d6d
1340,0.00012,1,3,4,14.050122216323361,#717171
1452,0.000113,1,2,3,13.5196994710513,#727272
1150,0.000399,2,1,3,29.32425401023552,#676767
1149,0.000546,2,0,2,35.27152599801792,#626262
1696,0.000133,1,1,2,14.999536055771733,#717171
1283,0.000255,1,2,3,22.430181432297555,#6b6b6b
1335,0.000287,2,1,3,24.089030084755148,#6a6a6a
1151,0.000824,5,0,5,44.805787883036594,#5c5c5c
1356,0.000361,6,2,8,27.632538684601606,#686868
1473,0.000259,2,1,3,22.642467293054047,#6b6b6b
1489,0.000206,4,4,8,19.695806249957098,#6d6d6d
1170,0.000705,7,3,10,40.93640293883049,#5f5f5f
1152,0.000373,3,0,3,28.175066819207885,#676767
1357,0.000113,1,2,3,13.5196994710513,#727272
1484,0.000149,2,4,6,16.112424734781012,#707070
1405,0.000128,1,1,2,14.639545810903515,#717171
1153,0.000316,2,0,2,25.521733050332923,#696969
1730,0.000133,1,1,2,14.999536055771733,#717171
1156,0.000369,3,1,4,27.995108790386844,#676767
1155,0.000594,3,0,3,37.051892691099866,#616161
1774,0.000094,0,2,2,12,#737373
1971,0.000173,1,1,2,17.685431661066666,#6f6f6f
1161,0.00016,2,1,3,16.846537660321623,#6f6f6f
1221,0.000133,1,1,2,14.999536055771733,#717171
1260,0.000094,0,3,3,12,#737373
1326,0.000645,6,4,10,38.87394055545218,#606060
1157,0.000499,3,0,3,33.45858881003785,#646464
1736,0.000094,0,2,2,12,#737373
1749,0.000269,2,1,3,23.166819740335022,#6b6b6b
1158,0.000495,5,0,5,33.300817328366165,#646464
1505,0.000094,0,4,4,12,#737373
1684,0.000094,0,2,2,12,#737373
1770,0.000094,0,2,2,12,#737373
1322,0.000112,1,1,2,13.442731432222969,#727272
2092,0.000094,0,2,2,12,#737373
1501,0.000094,0,2,2,12,#737373
1162,0.000546,4,0,4,35.27152599801792,#626262
1241,0.000216,1,1,2,20.275805650131435,#6d6d6d
1517,0.000133,1,1,2,14.999536055771733,#717171
1641,0.000094,0,1,1,12,#737373
1299,0.000201,2,2,4,19.40105797672826,#6e6e6e
1435,0.000186,2,3,5,18.496400996337503,#6e6e6e
1164,0.000266,4,0,4,23.01044912007304,#6b6b6b
1865,0.000094,0,2,2,12,#737373
2184,0.000094,0,2,2,12,#737373
2189,0.000094,0,2,2,12,#737373
1777,0.000133,1,1,2,14.999536055771733,#717171
1853,0.000094,0,2,2,12,#737373
2015,0.000094,0,2,2,12,#737373
1168,0.000094,0,1,1,12,#737373
1413,0.000133,1,2,3,14.999536055771733,#717171
1438,0.000133,1,2,3,14.999536055771733,#717171
1646,0.000133,1,1,2,14.999536055771733,#717171
1541,0.000094,0,4,4,12,#737373
1169,0.000344,2,0,2,26.849861079186745,#686868
1403,0.00018,3,3,6,18.125388039359912,#6e6e6e
1171,0.000144,1,1,2,15.770693283269225,#707070
1175,0.000195,2,1,3,19.04296905860749,#6e6e6e
1309,0.000817,7,4,11,44.58544873853682,#5c5c5c
2180,0.000173,1,2,3,17.685431661066666,#6f6f6f
1172,0.000167,1,0,1,17.301908082944657,#6f6f6f
1468,0.000225,4,1,5,20.787553985810852,#6d6d6d
1173,0.000609,6,0,6,37.5948562602,#616161
1487,0.000109,1,2,3,13.209951757949934,#727272
1649,0.000239,3,1,4,21.56564352455313,#6c6c6c
1184,0.001021,1,1,2,50.69558337238433,#585858
1174,0.001001,2,0,2,50.12249087961865,#585858
1518,0.000094,0,2,2,12,#737373
1467,0.00012,1,4,5,14.050122216323361,#717171
1265,0.000094,0,1,1,12,#737373
1387,0.000094,0,2,2,12,#737373
1735,0.000094,0,2,2,12,#737373
1181,0.000173,2,0,2,17.685431661066666,#6f6f6f
2164,0.000094,0,2,2,12,#737373
1190,0.000268,2,1,3,23.114783806097357,#6b6b6b
1182,0.000361,2,0,2,27.632538684601606,#686868
1398,0.000094,0,2,2,12,#737373
2447,0.001091,4,1,5,52.662696348962506,#575757
1185,0.000165,1,0,1,17.17269360034772,#6f6f6f
1949,0.000094,0,2,2,12,#737373
1186,0.000213,3,0,3,20.103098863481684,#6d6d6d
2050,0.000094,0,2,2,12,#737373
2075,0.000094,0,2,2,12,#737373
1188,0.000156,1,0,1,16.582296788749808,#707070
1234,0.000123,1,2,3,14.27316966065317,#717171
1845,0.000094,0,1,1,12,#737373
1246,0.000094,0,2,2,12,#737373
1407,0.000094,0,2,2,12,#737373
1528,0.000547,5,1,6,35.3093191041945,#626262
1195,0.000187,3,1,4,18.557709820386023,#6e6e6e
1194,0.000292,2,0,2,24.340542711983574,#6a6a6a
1678,0.000094,0,2,2,12,#737373
1521,0.000094,0,3,3,12,#737373
1349,0.000094,0,3,3,12,#737373
1198,0.000212,2,0,2,20.045287013917818,#6d6d6d
1512,0.000323,2,3,5,25.858570168259796,#696969
1200,0.000133,1,1,2,14.999536055771733,#717171
1199,0.000427,3,0,3,30.52475611326538,#666666
1348,0.000213,4,1,5,20.103098863481684,#6d6d6d
1891,0.000094,0,2,2,12,#737373
1892,0.000094,0,2,2,12,#737373
1203,0.00012,1,1,2,14.050122216323361,#717171
1202,0.000335,2,0,2,26.42845477314982,#696969
1204,0.000164,2,1,3,17.10782210585562,#6f6f6f
1364,0.000094,0,3,3,12,#737373
1253,0.00012,1,2,3,14.050122216323361,#717171
1290,0.000323,1,1,2,25.858570168259796,#696969
1205,0.000434,3,0,3,30.81929413439979,#666666
1449,0.000094,0,3,3,12,#737373
2086,0.000094,0,2,2,12,#737373
1206,0.00078,6,0,6,43.406400728946124,#5d5d5d
1359,0.000394,3,1,4,29.105935495221868,#676767
1705,0.000133,1,1,2,14.999536055771733,#717171
1866,0.000094,0,1,1,12,#737373
1989,0.000094,0,1,1,12,#737373
2037,0.000094,0,2,2,12,#737373
1441,0.000222,2,1,3,20.61801225297066,#6d6d6d
1794,0.000133,1,2,3,14.999536055771733,#717171
1209,0.000332,3,0,3,26.28685674490043,#696969
1679,0.000094,0,2,2,12,#737373
1211,0.000094,0,1,1,12,#737373
1536,0.000133,1,2,3,14.999536055771733,#717171
2076,0.000094,0,2,2,12,#737373
1213,0.000175,1,1,2,17.811938066790663,#6f6f6f
1212,0.000282,2,0,2,23.835537796096794,#6a6a6a
1346,0.000192,1,2,3,18.862066054200255,#6e6e6e
1215,0.000172,1,0,1,17.621931704978525,#6f6f6f
1425,0.000133,1,2,3,14.999536055771733,#717171
1247,0.000196,1,1,2,19.102991324867094,#6e6e6e
1218,0.000489,4,0,4,33.06308029825029,#646464
1385,0.00012,1,1,2,14.050122216323361,#717171
1450,0.000094,0,3,3,12,#737373
1687,0.000237,3,2,5,21.455768414852855,#6c6c6c
1219,0.000445,5,0,5,31.277854705039218,#656565
1417,0.00012,1,1,2,14.050122216323361,#717171
1689,0.000458,2,3,5,31.813263221565485,#656565
1767,0.000094,0,2,2,12,#737373
1912,0.000094,0,2,2,12,#737373
1251,0.000278,2,1,3,23.63128434186593,#6b6b6b
1292,0.000094,0,2,2,12,#737373
1254,0.000094,0,2,2,12,#737373
1524,0.0002,3,2,5,19.341713958828393,#6e6e6e
1225,0.000231,1,1,2,21.123614021758055,#6c6c6c
1262,0.000094,0,1,1,12,#737373
1432,0.000094,0,3,3,12,#737373
1594,0.000094,0,2,2,12,#737373
1647,0.000173,1,1,2,17.685431661066666,#6f6f6f
1727,0.000133,1,1,2,14.999536055771733,#717171
1746,0.000094,0,1,1,12,#737373
1799,0.000094,0,2,2,12,#737373
2194,0.000094,0,2,2,12,#737373
1709,0.000253,3,1,4,22.323476700598142,#6b6b6b
1231,0.000113,1,3,4,13.5196994710513,#727272
1229,0.000255,3,0,3,22.430181432297555,#6b6b6b
1239,0.000201,2,2,4,19.40105797672826,#6e6e6e
1232,0.000219,2,0,2,20.447436343276856,#6d6d6d
1233,0.000146,1,0,1,15.908016751672154,#707070
1236,0.0003,1,1,2,24.738966688159792,#6a6a6a
1235,0.000615,4,0,4,37.81035382568078,#616161
1577,0.000133,1,1,2,14.999536055771733,#717171
1723,0.000133,1,1,2,14.999536055771733,#717171
1902,0.000094,0,2,2,12,#737373
1237,0.000243,2,1,3,21.78415975388338,#6c6c6c
1238,0.00023,2,0,2,21.067879224360784,#6c6c6c
1532,0.00012,1,2,3,14.050122216323361,#717171
1329,0.00016,2,2,4,16.846537660321623,#6f6f6f
1483,0.000094,0,2,2,12,#737373
1355,0.000145,1,1,2,15.839461562490118,#707070
1291,0.00016,2,1,3,16.846537660321623,#6f6f6f
1725,0.000333,2,2,4,26.334119821353525,#696969
1726,0.000349,2,1,3,27.081832310819312,#686868
1995,0.000094,0,3,3,12,#737373
1383,0.00012,1,2,3,14.050122216323361,#717171
1423,0.000094,0,2,2,12,#737373
1507,0.000113,1,2,3,13.5196994710513,#727272
1245,0.000153,2,0,2,16.382109723928565,#707070
1384,0.00012,1,1,2,14.050122216323361,#717171
1913,0.000094,0,2,2,12,#737373
1256,0.000378,2,1,3,28.3987976045832,#676767
1289,0.0002,2,3,5,19.341713958828393,#6e6e6e
1250,0.00019,2,0,2,18.740756670053315,#6e6e6e
1389,0.00017,2,1,3,17.494431323525504,#6f6f6f
1252,0.000224,4,0,4,20.731153739353275,#6d6d6d
1304,0.000094,0,3,3,12,#737373
1570,0.000207,1,1,2,19.754368044230688,#6d6d6d
1255,0.000349,3,0,3,27.081832310819312,#686868
1762,0.000094,0,2,2,12,#737373
1798,0.000094,0,2,2,12,#737373
1763,0.000173,1,1,2,17.685431661066666,#6f6f6f
1258,0.000113,1,1,2,13.5196994710513,#727272
1992,0.000094,0,2,2,12,#737373
1259,0.00012,1,0,1,14.050122216323361,#717171
1263,0.00012,1,1,2,14.050122216323361,#717171
1261,0.000196,1,0,1,19.102991324867094,#6e6e6e
1264,0.000133,1,0,1,14.999536055771733,#717171
1266,0.000122,1,0,1,14.199095341257646,#717171
1268,0.000707,5,0,5,41.003762011225376,#5f5f5f
1410,0.000248,3,1,4,22.055041569506876,#6c6c6c
1472,0.000216,3,2,5,20.275805650131435,#6d6d6d
1776,0.000407,3,3,6,29.671019198494974,#666666
2182,0.000173,1,1,2,17.685431661066666,#6f6f6f
1373,0.000094,0,4,4,12,#737373
1271,0.000133,1,1,2,14.999536055771733,#717171
1270,0.000207,1,0,1,19.754368044230688,#6d6d6d
1634,0.000094,0,2,2,12,#737373
1273,0.000209,1,1,2,19.871111006625867,#6d6d6d
1272,0.000942,6,0,6,48.401120064424504,#5a5a5a
1274,0.00012,1,1,2,14.050122216323361,#717171
1569,0.000094,0,2,2,12,#737373
1586,0.000355,2,1,3,27.358232671492853,#686868
1626,0.00012,1,1,2,14.050122216323361,#717171
1928,0.000296,2,2,4,24.540360432916078,#6a6a6a
1307,0.000436,3,1,4,30.903054430226412,#656565
1278,0.000549,4,1,5,35.384812163377326,#626262
1352,0.00023,3,1,4,21.067879224360784,#6c6c6c
1466,0.000207,1,4,5,19.754368044230688,#6d6d6d
2203,0.000094,0,2,2,12,#737373
1279,0.000392,2,1,3,29.01825928350827,#676767
2120,0.000094,0,3,3,12,#737373
1281,0.00012,1,1,2,14.050122216323361,#717171
1523,0.000167,2,2,4,17.301908082944657,#6f6f6f
1786,0.000173,2,3,5,17.685431661066666,#6f6f6f
1282,0.000242,2,0,2,21.729683399131453,#6c6c6c
1701,0.000094,0,2,2,12,#737373
1377,0.00019,2,1,3,18.740756670053315,#6e6e6e
1284,0.000397,4,0,4,29.237075180617616,#676767
1526,0.000221,1,2,3,20.56126952844315,#6d6d6d
1835,0.000094,0,1,1,12,#737373
2141,0.000094,0,2,2,12,#737373
1286,0.000245,3,0,3,21.892810694385922,#6c6c6c
1535,0.000094,0,3,3,12,#737373
1800,0.000128,1,2,3,14.639545810903515,#717171
1287,0.00015,1,0,1,16.180148347028588,#707070
1288,0.000326,2,0,2,26.00192217315449,#696969
1801,0.000207,1,1,2,19.754368044230688,#6d6d6d
1934,0.000094,0,2,2,12,#737373
1409,0.000269,1,1,2,23.166819740335022,#6b6b6b
1803,0.000094,0,2,2,12,#737373
1994,0.000094,0,3,3,12,#737373
1294,0.000146,2,1,3,15.908016751672154,#707070
1293,0.000217,1,0,1,20.333134379934826,#6d6d6d
1296,0.000288,4,0,4,24.139489386177207,#6a6a6a
1350,0.00012,1,1,2,14.050122216323361,#717171
1426,0.000094,0,3,3,12,#737373
1629,0.000094,0,2,2,12,#737373
1298,0.000461,6,0,6,31.935843724487967,#656565
1302,0.000133,1,1,2,14.999536055771733,#717171
1562,0.00012,1,2,3,14.050122216323361,#717171
1805,0.000094,0,2,2,12,#737373
2158,0.000094,0,3,3,12,#737373
1807,0.00012,1,3,4,14.050122216323361,#717171
1303,0.00012,1,0,1,14.050122216323361,#717171
1305,0.000119,1,0,1,13.975216770645698,#727272
1433,0.000094,0,3,3,12,#737373
1812,0.000173,1,1,2,17.685431661066666,#6f6f6f
2060,0.000094,0,3,3,12,#737373
2594,0.000562,2,1,3,35.872531656299245,#626262
1310,0.00012,1,1,2,14.050122216323361,#717171
1316,0.000308,2,1,3,25.13263746265548,#696969
1814,0.000133,1,1,2,14.999536055771733,#717171
2138,0.000094,0,3,3,12,#737373
2185,0.000173,1,1,2,17.685431661066666,#6f6f6f
1540,0.000094,0,3,3,12,#737373
1312,0.000122,1,1,2,14.199095341257646,#717171
2036,0.000094,0,1,1,12,#737373
2191,0.000113,1,2,3,13.5196994710513,#727272
2192,0.000094,0,4,4,12,#737373
1443,0.000094,0,2,2,12,#737373
1315,0.00012,1,1,2,14.050122216323361,#717171
1816,0.000094,0,3,3,12,#737373
1817,0.000222,2,1,3,20.61801225297066,#6d6d6d
1406,0.000122,1,3,4,14.199095341257646,#717171
1819,0.000094,0,2,2,12,#737373
1319,0.00021,2,1,3,19.929293935525752,#6d6d6d
1318,0.000272,1,0,1,23.32240754705169,#6b6b6b
1440,0.000133,1,2,3,14.999536055771733,#717171
1320,0.000264,2,0,2,22.905760819989744,#6b6b6b
1527,0.000133,1,1,2,14.999536055771733,#717171
1412,0.000113,1,2,3,13.5196994710513,#727272
1321,0.00025,4,0,4,22.162705238099072,#6c6c6c
1522,0.000145,1,2,3,15.839461562490118,#707070
2156,0.000094,0,3,3,12,#737373
1324,0.000137,1,1,2,15.283163521922663,#717171
1374,0.000165,1,2,3,17.17269360034772,#6f6f6f
2097,0.000094,0,4,4,12,#737373
2098,0.000094,0,4,4,12,#737373
1325,0.00031,3,0,3,25.230333578472866,#696969
1822,0.000094,0,2,2,12,#737373
1881,0.000094,0,2,2,12,#737373
1327,0.000136,2,1,3,15.212609940615039,#717171
1328,0.000094,0,1,1,12,#737373
1580,0.000133,1,1,2,14.999536055771733,#717171
1821,0.000133,1,1,2,14.999536055771733,#717171
1333,0.000391,5,0,5,28.97434569732119,#676767
1631,0.000094,0,2,2,12,#737373
2016,0.000094,0,2,2,12,#737373
1369,0.000133,1,2,3,14.999536055771733,#717171
1391,0.00015,1,2,3,16.180148347028588,#707070
1396,0.000094,0,2,2,12,#737373
1502,0.000116,1,2,3,13.748783606650441,#727272
1515,0.000133,1,2,3,14.999536055771733,#717171
1558,0.000094,0,2,2,12,#737373
1337,0.000173,2,1,3,17.685431661066666,#6f6f6f
1336,0.000241,1,0,1,21.675105650777578,#6c6c6c
1663,0.000094,0,2,2,12,#737373
1997,0.000094,0,2,2,12,#737373
1831,0.000184,2,1,3,18.373336658075203,#6e6e6e
1339,0.000389,3,0,3,28.88636662954051,#676767
1341,0.000198,1,1,2,19.222623922752323,#6e6e6e
1462,0.000218,1,2,3,20.390344347943245,#6d6d6d
1448,0.000123,1,1,2,14.27316966065317,#717171
1342,0.000504,5,0,5,33.65500504372394,#646464
1427,0.00012,1,1,2,14.050122216323361,#717171
1508,0.000207,1,1,2,19.754368044230688,#6d6d6d
1860,0.000094,0,1,1,12,#737373
1344,0.000141,1,0,1,15.56308822919205,#707070
1761,0.000116,1,1,2,13.748783606650441,#727272
1347,0.000456,3,0,3,31.73134206884572,#656565
1842,0.000358,3,1,4,27.495644279994334,#686868
1354,0.000094,0,1,1,12,#737373
1859,0.000133,1,1,2,14.999536055771733,#717171
2007,0.000094,0,2,2,12,#737373
1358,0.000247,2,0,2,22.0010632357656,#6c6c6c
1765,0.000133,1,1,2,14.999536055771733,#717171
1719,0.000133,1,1,2,14.999536055771733,#717171
1867,0.000094,0,2,2,12,#737373
2044,0.000173,1,1,2,17.685431661066666,#6f6f6f
1360,0.000557,5,0,5,35.68555429381049,#626262
1363,0.000207,2,1,3,19.754368044230688,#6d6d6d
1775,0.000113,1,1,2,13.5196994710513,#727272
1929,0.000133,1,2,3,14.999536055771733,#717171
1950,0.000094,0,4,4,12,#737373
1362,0.000191,1,1,2,18.801482814356014,#6e6e6e
1864,0.000094,0,2,2,12,#737373
1919,0.000094,0,2,2,12,#737373
1500,0.000094,0,2,2,12,#737373
1366,0.000224,2,0,2,20.731153739353275,#6d6d6d
1516,0.000213,2,2,4,20.103098863481684,#6d6d6d
1388,0.000212,1,1,2,20.045287013917818,#6d6d6d
1400,0.00016,2,3,5,16.846537660321623,#6f6f6f
1368,0.000366,3,0,3,27.85956352259946,#686868
1903,0.000207,1,1,2,19.754368044230688,#6d6d6d
1975,0.000094,0,2,2,12,#737373
1370,0.000247,2,0,2,22.0010632357656,#6c6c6c
1445,0.000094,0,2,2,12,#737373
1538,0.000094,0,1,1,12,#737373
1539,0.000094,0,1,1,12,#737373
1372,0.000255,3,0,3,22.430181432297555,#6b6b6b
1376,0.000122,1,1,2,14.199095341257646,#717171
1375,0.000197,1,0,1,19.16287594224734,#6e6e6e
1382,0.000145,1,2,3,15.839461562490118,#707070
1378,0.000358,5,0,5,27.495644279994334,#686868
1593,0.000094,0,2,2,12,#737373
2104,0.000133,1,1,2,14.999536055771733,#717171
1380,0.000397,3,0,3,29.237075180617616,#676767
1893,0.000183,2,1,3,18.311578797501046,#6e6e6e
1381,0.000195,2,0,2,19.04296905860749,#6e6e6e
1397,0.000094,0,2,2,12,#737373
1895,0.000094,0,3,3,12,#737373
1399,0.000139,1,1,2,15.423579008661793,#707070
1632,0.000094,0,2,2,12,#737373
1390,0.000566,3,0,3,36.02157518058237,#626262
1439,0.000414,4,1,5,29.97193062100049,#666666
1392,0.00012,1,0,1,14.050122216323361,#717171
1393,0.000213,2,0,2,20.103098863481684,#6d6d6d
1404,0.000094,0,1,1,12,#737373
1394,0.00015,1,0,1,16.180148347028588,#707070
1395,0.000133,1,0,1,14.999536055771733,#717171
1485,0.000094,0,2,2,12,#737373
1408,0.000213,3,0,3,20.103098863481684,#6d6d6d
1980,0.000094,0,2,2,12,#737373
1983,0.000094,0,2,2,12,#737373
1470,0.000207,1,1,2,19.754368044230688,#6d6d6d
2113,0.000094,0,3,3,12,#737373
1411,0.000142,1,0,1,15.632508821476176,#707070
2193,0.000094,0,2,2,12,#737373
1414,0.000112,1,0,1,13.442731432222969,#727272
1415,0.000265,4,0,4,22.958149413296184,#6b6b6b
1844,0.00012,1,2,3,14.050122216323361,#717171
1920,0.000094,0,2,2,12,#737373
1921,0.000094,0,3,3,12,#737373
1455,0.00023,3,1,4,21.067879224360784,#6c6c6c
1828,0.000173,1,1,2,17.685431661066666,#6f6f6f
1923,0.000094,0,2,2,12,#737373
1963,0.000094,0,2,2,12,#737373
1421,0.000122,1,0,1,14.199095341257646,#717171
1924,0.000094,0,2,2,12,#737373
1428,0.00016,2,0,2,16.846537660321623,#6f6f6f
1431,0.00012,1,1,2,14.050122216323361,#717171
1430,0.000302,3,0,3,24.8378228436656,#6a6a6a
1974,0.000094,0,1,1,12,#737373
1930,0.000133,1,5,6,14.999536055771733,#717171
1783,0.000207,1,1,2,19.754368044230688,#6d6d6d
1437,0.000309,2,0,2,25.18152108960815,#696969
1935,0.000094,0,2,2,12,#737373
1811,0.000094,0,2,2,12,#737373
1884,0.000094,0,1,1,12,#737373
1537,0.000094,0,2,2,12,#737373
1548,0.000094,0,2,2,12,#737373
1987,0.000094,0,2,2,12,#737373
2077,0.000142,1,1,2,15.632508821476176,#707070
2118,0.000109,1,2,3,13.209951757949934,#727272
2119,0.000094,0,4,4,12,#737373
1456,0.000094,0,2,2,12,#737373
1457,0.000094,0,2,2,12,#737373
1598,0.000133,1,2,3,14.999536055771733,#717171
1952,0.000094,0,2,2,12,#737373
2072,0.000239,1,1,2,21.56564352455313,#6c6c6c
2074,0.000131,1,1,2,14.856283440227312,#717171
2081,0.000094,0,2,2,12,#737373
2095,0.000094,0,2,2,12,#737373
2105,0.000113,1,1,2,13.5196994710513,#727272
2108,0.000094,0,2,2,12,#737373
2123,0.000133,1,1,2,14.999536055771733,#717171
2144,0.000094,0,2,2,12,#737373
2124,0.000094,0,2,2,12,#737373
2125,0.000094,0,2,2,12,#737373
1953,0.000407,6,1,7,29.671019198494974,#666666
1464,0.000137,1,0,1,15.283163521922663,#717171
1465,0.000137,1,0,1,15.283163521922663,#717171
1908,0.000133,1,1,2,14.999536055771733,#717171
1748,0.000094,0,2,2,12,#737373
1954,0.000094,0,4,4,12,#737373
2188,0.000094,0,2,2,12,#737373
2112,0.000133,1,1,2,14.999536055771733,#717171
2173,0.000094,0,2,2,12,#737373
2128,0.000133,1,2,3,14.999536055771733,#717171
2129,0.000094,0,3,3,12,#737373
2131,0.000113,1,1,2,13.5196994710513,#727272
1475,0.000094,0,1,1,12,#737373
2042,0.000094,0,2,2,12,#737373
1477,0.00013,1,0,1,14.784288150134541,#717171
1480,0.00012,1,1,2,14.050122216323361,#717171
1479,0.000196,1,0,1,19.102991324867094,#6e6e6e
2157,0.000094,0,5,5,12,#737373
1621,0.000133,1,1,2,14.999536055771733,#717171
1760,0.000247,2,2,4,22.0010632357656,#6c6c6c
1984,0.000094,0,1,1,12,#737373
1492,0.0004,4,0,4,29.367769677189468,#676767
1565,0.000133,1,1,2,14.999536055771733,#717171
1710,0.000133,1,1,2,14.999536055771733,#717171
1986,0.000094,0,2,2,12,#737373
1494,0.000284,3,0,3,23.937175492264057,#6a6a6a
1988,0.000094,0,1,1,12,#737373
2010,0.000094,0,3,3,12,#737373
1999,0.000133,1,5,6,14.999536055771733,#717171
1514,0.000094,0,1,1,12,#737373
1818,0.000094,0,2,2,12,#737373
2202,0.000133,1,1,2,14.999536055771733,#717171
1876,0.000133,1,1,2,14.999536055771733,#717171
1509,0.00015,1,0,1,16.180148347028588,#707070
1511,0.000213,3,0,3,20.103098863481684,#6d6d6d
2019,0.000142,1,3,4,15.632508821476176,#707070
1513,0.000213,2,1,3,20.103098863481684,#6d6d6d
2020,0.000171,2,3,5,17.5582653966192,#6f6f6f
2022,0.000094,0,1,1,12,#737373
1925,0.000094,0,1,1,12,#737373
2027,0.000094,0,2,2,12,#737373
1519,0.00012,1,0,1,14.050122216323361,#717171
1520,0.00016,2,0,2,16.846537660321623,#6f6f6f
1588,0.000094,0,2,2,12,#737373
1979,0.000094,0,2,2,12,#737373
2031,0.00012,1,3,4,14.050122216323361,#717171
1926,0.00015,1,1,2,16.180148347028588,#707070
1529,0.000133,1,1,2,14.999536055771733,#717171
1694,0.000133,1,1,2,14.999536055771733,#717171
1695,0.000173,1,1,2,17.685431661066666,#6f6f6f
2126,0.000094,0,2,2,12,#737373
1533,0.000094,0,1,1,12,#737373
1644,0.000253,3,1,4,22.323476700598142,#6b6b6b
1938,0.000094,0,2,2,12,#737373
1611,0.000198,1,1,2,19.222623922752323,#6e6e6e
1547,0.000659,6,1,7,39.362649384034704,#606060
1544,0.000753,2,0,2,42.53005380267837,#5e5e5e
1832,0.000116,1,1,2,13.748783606650441,#727272
1575,0.00027,2,1,3,23.218768698136756,#6b6b6b
1545,0.000363,2,0,2,27.72351736267923,#686868
2040,0.000094,0,2,2,12,#737373
1546,0.000213,2,0,2,20.103098863481684,#6d6d6d
1888,0.000094,0,1,1,12,#737373
1595,0.000094,0,1,1,12,#737373
1638,0.000116,1,1,2,13.748783606650441,#727272
1708,0.000143,1,1,2,15.701709764920519,#707070
1733,0.000133,1,1,2,14.999536055771733,#717171
1744,0.000133,1,1,2,14.999536055771733,#717171
1782,0.000133,1,3,4,14.999536055771733,#717171
1549,0.000233,2,0,2,21.234758886801874,#6c6c6c
2110,0.00012,1,1,2,14.050122216323361,#717171
1550,0.00032,2,0,2,25.714617749683157,#696969
1931,0.000094,0,1,1,12,#737373
1779,0.000133,1,1,2,14.999536055771733,#717171
1551,0.000269,2,0,2,23.166819740335022,#6b6b6b
1993,0.000147,2,2,4,15.97636096389552,#707070
1653,0.000364,4,1,5,27.76892210605493,#686868
1670,0.000156,1,2,3,16.582296788749808,#707070
1720,0.000094,0,1,1,12,#737373
1740,0.000094,0,2,2,12,#737373
1839,0.000133,1,2,3,14.999536055771733,#717171
1890,0.000094,0,2,2,12,#737373
1957,0.000094,0,1,1,12,#737373
2142,0.000094,0,2,2,12,#737373
1561,0.000133,1,1,2,14.999536055771733,#717171
1555,0.000247,2,0,2,22.0010632357656,#6c6c6c
1841,0.000094,0,2,2,12,#737373
1712,0.000133,1,1,2,14.999536055771733,#717171
1557,0.000327,2,0,2,26.049574136619064,#696969
1846,0.000142,1,1,2,15.632508821476176,#707070
1781,0.000094,0,2,2,12,#737373
1563,0.000376,3,0,3,28.30946605998667,#676767
1787,0.000133,1,1,2,14.999536055771733,#717171
1857,0.000094,0,2,2,12,#737373
1564,0.000153,2,0,2,16.382109723928565,#707070
1745,0.000094,0,2,2,12,#737373
1567,0.000094,0,1,1,12,#737373
1568,0.000094,0,1,1,12,#737373
1618,0.000133,1,1,2,14.999536055771733,#717171
1571,0.000173,2,0,2,17.685431661066666,#6f6f6f
1685,0.000222,3,3,6,20.61801225297066,#6d6d6d
1572,0.000196,2,0,2,19.102991324867094,#6e6e6e
1574,0.00016,2,1,3,16.846537660321623,#6f6f6f
2053,0.000133,1,1,2,14.999536055771733,#717171
2099,0.000094,0,3,3,12,#737373
2115,0.000094,0,2,2,12,#737373
1946,0.000133,1,1,2,14.999536055771733,#717171
1645,0.000094,0,2,2,12,#737373
1578,0.00028,2,0,2,23.7335752027898,#6a6a6a
1985,0.000173,2,1,3,17.685431661066666,#6f6f6f
1657,0.000094,0,1,1,12,#737373
1582,0.000173,1,1,2,17.685431661066666,#6f6f6f
1764,0.000094,0,1,1,12,#737373
1691,0.000133,1,2,3,14.999536055771733,#717171
1583,0.00023,3,0,3,21.067879224360784,#6c6c6c
1918,0.000094,0,2,2,12,#737373
2087,0.000094,0,2,2,12,#737373
1599,0.00012,1,2,3,14.050122216323361,#717171
1855,0.000154,2,1,3,16.449033409962986,#707070
1856,0.000128,1,1,2,14.639545810903515,#717171
1951,0.00012,1,3,4,14.050122216323361,#717171
2000,0.000094,0,3,3,12,#737373
2012,0.000094,0,3,3,12,#737373
1721,0.000156,2,1,3,16.582296788749808,#707070
1585,0.000266,2,0,2,23.01044912007304,#6b6b6b
1702,0.00016,2,1,3,16.846537660321623,#6f6f6f
1587,0.000173,2,0,2,17.685431661066666,#6f6f6f
1589,0.000237,4,0,4,21.455768414852855,#6c6c6c
2150,0.000094,0,3,3,12,#737373
1716,0.00016,2,1,3,16.846537660321623,#6f6f6f
1590,0.000343,2,0,2,26.803285186298606,#686868
1854,0.000133,1,1,2,14.999536055771733,#717171
1591,0.000263,2,0,2,22.85328285153254,#6b6b6b
1592,0.000213,2,0,2,20.103098863481684,#6d6d6d
2048,0.000094,0,1,1,12,#737373
1960,0.000094,0,2,2,12,#737373
1596,0.000171,2,0,2,17.5582653966192,#6f6f6f
2038,0.000133,1,3,4,14.999536055771733,#717171
1597,0.00015,1,0,1,16.180148347028588,#707070
1686,0.000094,0,2,2,12,#737373
1601,0.000374,2,1,3,28.21992043253382,#676767
1600,0.000561,4,0,4,35.835196259781775,#626262
1922,0.000129,2,1,3,14.712043210723964,#717171
1838,0.00012,1,2,3,14.050122216323361,#717171
1972,0.000269,1,1,2,23.166819740335022,#6b6b6b
2001,0.00014,1,2,3,15.493445725621832,#707070
1602,0.000226,3,0,3,20.843841544046825,#6d6d6d
2130,0.000133,1,2,3,14.999536055771733,#717171
2151,0.000094,0,5,5,12,#737373
1648,0.000128,1,1,2,14.639545810903515,#717171
1604,0.000344,3,0,3,26.849861079186745,#686868
1773,0.000094,0,2,2,12,#737373
1823,0.00012,1,1,2,14.050122216323361,#717171
1699,0.000209,1,2,3,19.871111006625867,#6d6d6d
1820,0.000133,1,2,3,14.999536055771733,#717171
2043,0.000094,0,2,2,12,#737373
1606,0.000133,1,0,1,14.999536055771733,#717171
1674,0.000148,1,1,2,16.044496277075513,#707070
1607,0.000259,2,0,2,22.642467293054047,#6b6b6b
1970,0.000094,0,2,2,12,#737373
1608,0.000213,2,0,2,20.103098863481684,#6d6d6d
1998,0.000094,0,1,1,12,#737373
2065,0.000113,1,1,2,13.5196994710513,#727272
2148,0.000094,0,2,2,12,#737373
1613,0.00012,1,1,2,14.050122216323361,#717171
1612,0.000402,3,0,3,29.454654404936605,#666666
1627,0.000196,1,1,2,19.102991324867094,#6e6e6e
1847,0.000094,0,3,3,12,#737373
1654,0.000188,2,1,3,18.618871286344486,#6e6e6e
1614,0.000289,3,0,3,24.189869906310776,#6a6a6a
1659,0.000133,1,1,2,14.999536055771733,#717171
1834,0.000094,0,2,2,12,#737373
1616,0.000173,2,0,2,17.685431661066666,#6f6f6f
1617,0.00019,2,0,2,18.740756670053315,#6e6e6e
1700,0.000094,0,2,2,12,#737373
1882,0.000094,0,2,2,12,#737373
1623,0.000341,4,1,5,26.70994970428908,#686868
1692,0.000157,1,1,2,16.648640101132177,#707070
1662,0.00016,2,2,4,16.846537660321623,#6f6f6f
2014,0.000133,1,1,2,14.999536055771733,#717171
2004,0.000133,1,1,2,14.999536055771733,#717171
2003,0.000094,0,3,3,12,#737373
1664,0.00012,1,1,2,14.050122216323361,#717171
1628,0.000173,2,0,2,17.685431661066666,#6f6f6f
1729,0.000133,1,1,2,14.999536055771733,#717171
1813,0.000133,1,1,2,14.999536055771733,#717171
1633,0.000273,3,0,3,23.374098358988334,#6b6b6b
1848,0.000094,0,2,2,12,#737373
1964,0.000094,0,3,3,12,#737373
1667,0.000094,0,2,2,12,#737373
1635,0.000372,2,0,2,28.130159060209138,#676767
1703,0.00028,2,1,3,23.7335752027898,#6a6a6a
1738,0.000094,0,3,3,12,#737373
1636,0.000233,2,0,2,21.234758886801874,#6c6c6c
1824,0.000133,1,1,2,14.999536055771733,#717171
1637,0.00012,1,0,1,14.050122216323361,#717171
1911,0.000094,0,1,1,12,#737373
1639,0.000213,2,0,2,20.103098863481684,#6d6d6d
1766,0.000133,1,1,2,14.999536055771733,#717171
1640,0.000247,2,0,2,22.0010632357656,#6c6c6c
1804,0.000094,0,2,2,12,#737373
1642,0.000263,2,0,2,22.85328285153254,#6b6b6b
1643,0.000209,2,0,2,19.871111006625867,#6d6d6d
2067,0.000094,0,3,3,12,#737373
1751,0.000094,0,1,1,12,#737373
1909,0.000094,0,2,2,12,#737373
1916,0.000094,0,1,1,12,#737373
1752,0.000109,1,2,3,13.209951757949934,#727272
2068,0.000094,0,1,1,12,#737373
1788,0.000133,1,1,2,14.999536055771733,#717171
1650,0.000247,2,0,2,22.0010632357656,#6c6c6c
1795,0.000173,2,3,5,17.685431661066666,#6f6f6f
1651,0.000182,2,0,2,18.249668885536508,#6e6e6e
1797,0.000094,0,2,2,12,#737373
1759,0.000131,1,1,2,14.856283440227312,#717171
1652,0.000338,2,0,2,26.56948332138532,#686868
1879,0.000156,1,1,2,16.582296788749808,#707070
1742,0.00016,2,1,3,16.846537660321623,#6f6f6f
1790,0.000094,0,2,2,12,#737373
2039,0.000133,1,2,3,14.999536055771733,#717171
1883,0.000113,1,2,3,13.5196994710513,#727272
1897,0.000113,1,4,5,13.5196994710513,#727272
1655,0.000118,1,0,1,13.900027528737976,#727272
1656,0.000118,1,0,1,13.900027528737976,#727272
1771,0.000302,1,1,2,24.8378228436656,#6a6a6a
1658,0.000399,2,0,2,29.32425401023552,#676767
1826,0.000094,0,2,2,12,#737373
1827,0.000193,2,1,3,18.92250746755846,#6e6e6e
1660,0.000297,2,0,2,24.590124646255656,#6a6a6a
1661,0.000354,3,0,3,27.31231277408949,#686868
1850,0.00016,2,1,3,16.846537660321623,#6f6f6f
1722,0.000094,0,2,2,12,#737373
2163,0.000094,0,3,3,12,#737373
1862,0.00015,1,1,2,16.180148347028588,#707070
1665,0.000261,2,0,2,22.74805681184243,#6b6b6b
1915,0.000094,0,2,2,12,#737373
1808,0.00015,1,1,2,16.180148347028588,#707070
1668,0.000261,2,0,2,22.74805681184243,#6b6b6b
1669,0.000307,2,0,2,25.083682362465577,#6a6a6a
1754,0.000173,2,1,3,17.685431661066666,#6f6f6f
1789,0.00012,1,1,2,14.050122216323361,#717171
1671,0.000275,2,0,2,23.477225028974956,#6b6b6b
2013,0.000094,0,1,1,12,#737373
1672,0.00012,1,0,1,14.050122216323361,#717171
1673,0.000218,2,0,2,20.390344347943245,#6d6d6d
1706,0.000133,1,1,2,14.999536055771733,#717171
1675,0.000207,1,0,1,19.754368044230688,#6d6d6d
1676,0.000267,2,0,2,23.0626604244448,#6b6b6b
1906,0.000173,1,1,2,17.685431661066666,#6f6f6f
1734,0.000375,3,1,4,28.26472010998426,#676767
1680,0.000452,2,0,2,31.567013188193116,#656565
1875,0.000094,0,1,1,12,#737373
1681,0.000213,2,0,2,20.103098863481684,#6d6d6d
1682,0.00019,2,0,2,18.740756670053315,#6e6e6e
1778,0.000094,0,2,2,12,#737373
1683,0.000133,1,0,1,14.999536055771733,#717171
1878,0.000094,0,2,2,12,#737373
1688,0.000094,0,1,1,12,#737373
2167,0.000094,0,2,2,12,#737373
1714,0.000381,1,1,2,28.532397098919894,#676767
1690,0.000266,3,0,3,23.01044912007304,#6b6b6b
1861,0.000113,1,1,2,13.5196994710513,#727272
1869,0.00015,1,2,3,16.180148347028588,#707070
1858,0.000133,1,1,2,14.999536055771733,#717171
1693,0.000247,2,0,2,22.0010632357656,#6c6c6c
1907,0.000094,0,2,2,12,#737373
1967,0.000094,0,1,1,12,#737373
1697,0.000128,1,0,1,14.639545810903515,#717171
1698,0.000322,2,0,2,25.81065314144071,#696969
1982,0.000133,1,1,2,14.999536055771733,#717171
1780,0.000173,1,1,2,17.685431661066666,#6f6f6f
1724,0.000143,1,1,2,15.701709764920519,#707070
1704,0.000254,2,0,2,22.37687632753905,#6b6b6b
1976,0.000094,0,2,2,12,#737373
1829,0.000133,1,1,2,14.999536055771733,#717171
1707,0.000247,2,0,2,22.0010632357656,#6c6c6c
1870,0.000094,0,2,2,12,#737373
2100,0.000094,0,1,1,12,#737373
1896,0.000094,0,2,2,12,#737373
1711,0.00016,2,0,2,16.846537660321623,#6f6f6f
1904,0.000094,0,2,2,12,#737373
1843,0.000173,1,1,2,17.685431661066666,#6f6f6f
1739,0.000339,1,1,2,26.61636755519475,#686868
1961,0.000173,2,1,3,17.685431661066666,#6f6f6f
1715,0.000343,2,0,2,26.803285186298606,#686868
2111,0.00012,1,1,2,14.050122216323361,#717171
1889,0.000094,0,2,2,12,#737373
2136,0.00012,1,1,2,14.050122216323361,#717171
1718,0.000133,1,0,1,14.999536055771733,#717171
1849,0.000094,0,2,2,12,#737373
1945,0.000251,4,1,5,22.21639170604164,#6c6c6c
2080,0.000094,0,3,3,12,#737373
1755,0.000233,2,1,3,21.234758886801874,#6c6c6c
1977,0.000133,1,2,3,14.999536055771733,#717171
1732,0.000216,3,0,3,20.275805650131435,#6d6d6d
2117,0.000094,0,2,2,12,#737373
2052,0.000094,0,2,2,12,#737373
1758,0.000131,1,1,2,14.856283440227312,#717171
1802,0.000153,1,1,2,16.382109723928565,#707070
2051,0.000094,0,2,2,12,#737373
1737,0.00012,1,0,1,14.050122216323361,#717171
1785,0.000289,1,1,2,24.189869906310776,#6a6a6a
1743,0.000094,0,2,2,12,#737373
1741,0.000194,3,0,3,18.982808118734695,#6e6e6e
1793,0.00012,1,3,4,14.050122216323361,#717171
2025,0.000094,0,3,3,12,#737373
2162,0.000094,0,3,3,12,#737373
1747,0.000292,4,0,4,24.340542711983574,#6a6a6a
2008,0.000094,0,1,1,12,#737373
2183,0.000094,0,2,2,12,#737373
1885,0.00016,2,1,3,16.846537660321623,#6f6f6f
1833,0.000094,0,2,2,12,#737373
1756,0.000133,1,1,2,14.999536055771733,#717171
1757,0.0002,3,0,3,19.341713958828393,#6e6e6e
1898,0.000133,1,1,2,14.999536055771733,#717171
2088,0.000094,0,2,2,12,#737373
1880,0.000094,0,1,1,12,#737373
1840,0.000094,0,2,2,12,#737373
1768,0.000133,1,0,1,14.999536055771733,#717171
1769,0.00028,2,0,2,23.7335752027898,#6a6a6a
2032,0.000173,2,1,3,17.685431661066666,#6f6f6f
1899,0.000245,2,1,3,21.892810694385922,#6c6c6c
1772,0.000173,2,0,2,17.685431661066666,#6f6f6f
1886,0.000094,0,1,1,12,#737373
1962,0.0002,3,1,4,19.341713958828393,#6e6e6e
1947,0.000094,0,1,1,12,#737373
2011,0.000094,0,2,2,12,#737373
1900,0.000133,1,1,2,14.999536055771733,#717171
1910,0.000229,1,1,2,21.012035273453705,#6c6c6c
2041,0.000094,0,2,2,12,#737373
1791,0.000128,1,0,1,14.639545810903515,#717171
1792,0.000128,1,0,1,14.639545810903515,#717171
1796,0.000094,0,2,2,12,#737373
1996,0.000133,1,1,2,14.999536055771733,#717171
1806,0.00012,1,0,1,14.050122216323361,#717171
1851,0.000094,0,1,1,12,#737373
2023,0.000094,0,2,2,12,#737373
1815,0.000167,2,0,2,17.301908082944657,#6f6f6f
2149,0.00012,1,1,2,14.050122216323361,#717171
2046,0.00012,1,2,3,14.050122216323361,#717171
2006,0.000094,0,1,1,12,#737373
2034,0.000094,0,2,2,12,#737373
2155,0.000094,0,2,2,12,#737373
1836,0.000133,1,0,1,14.999536055771733,#717171
2049,0.000094,0,2,2,12,#737373
2070,0.000131,1,1,2,14.856283440227312,#717171
2079,0.000133,1,1,2,14.999536055771733,#717171
2122,0.000094,0,2,2,12,#737373
1981,0.000094,0,1,1,12,#737373
1933,0.000292,4,1,5,24.340542711983574,#6a6a6a
1917,0.000116,1,2,3,13.748783606650441,#727272
1868,0.000166,2,0,2,17.237388412297367,#6f6f6f
2106,0.000133,1,2,3,14.999536055771733,#717171
1872,0.00012,1,1,2,14.050122216323361,#717171
1871,0.00035,3,0,3,27.12804667565457,#686868
1873,0.00015,1,1,2,16.180148347028588,#707070
2047,0.000094,0,3,3,12,#737373
2145,0.000094,0,4,4,12,#737373
1887,0.000129,2,0,2,14.712043210723964,#717171
2030,0.000094,0,2,2,12,#737373
1894,0.000267,2,0,2,23.0626604244448,#6b6b6b
1936,0.000173,1,1,2,17.685431661066666,#6f6f6f
1958,0.000131,1,1,2,14.856283440227312,#717171
1990,0.000133,1,1,2,14.999536055771733,#717171
1941,0.000094,0,1,1,12,#737373
1978,0.00016,2,1,3,16.846537660321623,#6f6f6f
1940,0.000133,1,2,3,14.999536055771733,#717171
1927,0.000177,2,0,2,17.937795520999256,#6f6f6f
2177,0.000207,1,1,2,19.754368044230688,#6d6d6d
2196,0.000094,0,2,2,12,#737373
1944,0.000094,0,2,2,12,#737373
2116,0.000094,0,1,1,12,#737373
1937,0.000094,0,1,1,12,#737373
1939,0.00015,1,0,1,16.180148347028588,#707070
1943,0.000156,2,0,2,16.582296788749808,#707070
2089,0.00012,1,2,3,14.050122216323361,#717171
2114,0.000109,1,2,3,13.209951757949934,#727272
2033,0.000094,0,2,2,12,#737373
2056,0.000157,1,1,2,16.648640101132177,#707070
2137,0.00012,1,3,4,14.050122216323361,#717171
2140,0.000094,0,3,3,12,#737373
2143,0.000094,0,2,2,12,#737373
2186,0.000094,0,2,2,12,#737373
2187,0.000094,0,2,2,12,#737373
2029,0.000094,0,2,2,12,#737373
1966,0.000094,0,1,1,12,#737373
1965,0.000253,3,0,3,22.323476700598142,#6b6b6b
1968,0.000173,2,0,2,17.685431661066666,#6f6f6f
1991,0.000094,0,1,1,12,#737373
2133,0.000207,2,1,3,19.754368044230688,#6d6d6d
2009,0.000094,0,1,1,12,#737373
1973,0.0002,2,0,2,19.341713958828393,#6e6e6e
2175,0.000094,0,3,3,12,#737373
2078,0.000094,0,2,2,12,#737373
2161,0.000094,0,2,2,12,#737373
2026,0.000094,0,2,2,12,#737373
2005,0.00012,1,0,1,14.050122216323361,#717171
2127,0.000094,0,2,2,12,#737373
2018,0.000094,0,1,1,12,#737373
2024,0.00012,1,0,1,14.050122216323361,#717171
2045,0.000094,0,1,1,12,#737373
2054,0.00018,3,0,3,18.125388039359912,#6e6e6e
2055,0.000153,2,0,2,16.382109723928565,#707070
2107,0.000094,0,4,4,12,#737373
2084,0.00015,1,2,3,16.180148347028588,#707070
2059,0.000094,0,1,1,12,#737373
2057,0.0002,2,0,2,19.341713958828393,#6e6e6e
2058,0.00015,1,0,1,16.180148347028588,#707070
2066,0.0002,3,0,3,19.341713958828393,#6e6e6e
2101,0.000133,1,3,4,14.999536055771733,#717171
2165,0.000094,0,1,1,12,#737373
2166,0.000094,0,1,1,12,#737373
2073,0.000171,2,1,3,17.5582653966192,#6f6f6f
2083,0.000254,2,1,3,22.37687632753905,#6b6b6b
2082,0.0004,3,0,3,29.367769677189468,#676767
2085,0.000133,1,2,3,14.999536055771733,#717171
2094,0.000113,1,1,2,13.5196994710513,#727272
2134,0.000094,0,2,2,12,#737373
2090,0.000173,2,0,2,17.685431661066666,#6f6f6f
2190,0.000094,0,3,3,12,#737373
2093,0.000133,1,0,1,14.999536055771733,#717171
2102,0.000247,3,0,3,22.0010632357656,#6c6c6c
2146,0.000173,1,2,3,17.685431661066666,#6f6f6f
2103,0.000129,2,0,2,14.712043210723964,#717171
2154,0.000094,0,2,2,12,#737373
2153,0.000094,0,2,2,12,#737373
2132,0.000113,1,0,1,13.5196994710513,#727272
2147,0.000094,0,1,1,12,#737373
2152,0.00012,1,0,1,14.050122216323361,#717171
2169,0.000094,0,1,1,12,#737373
2170,0.000094,0,1,1,12,#737373
2160,0.00016,2,0,2,16.846537660321623,#6f6f6f
2168,0.00012,1,0,1,14.050122216323361,#717171
2171,0.000113,1,0,1,13.5196994710513,#727272
2172,0.000113,1,0,1,13.5196994710513,#727272
2174,0.00012,1,0,1,14.050122216323361,#717171
2178,0.000133,1,1,2,14.999536055771733,#717171
2181,0.000094,0,1,1,12,#737373
2197,0.000094,0,1,1,12,#737373
2198,0.000094,0,1,1,12,#737373
2200,0.000207,1,1,2,19.754368044230688,#6d6d6d
2199,0.000309,2,0,2,25.18152108960815,#696969
2204,0.000094,0,2,2,12,#737373
2201,0.000133,1,1,2,14.999536055771733,#717171
2210,0.000173,1,1,2,17.685431661066666,#6f6f6f
2205,0.000388,2,0,2,28.842300770516935,#676767
2211,0.000173,1,1,2,17.685431661066666,#6f6f6f
2382,0.000433,6,7,13,30.777348855163215,#666666
2206,0.000146,1,0,1,15.908016751672154,#707070
2244,0.000139,1,2,3,15.423579008661793,#707070
2208,0.000266,2,0,2,23.01044912007304,#6b6b6b
2390,0.000133,1,1,2,14.999536055771733,#717171
2412,0.000094,0,2,2,12,#737373
2209,0.000173,2,0,2,17.685431661066666,#6f6f6f
4743,0.000094,0,2,2,12,#737373
2212,0.000187,2,2,4,18.557709820386023,#6e6e6e
2396,0.000133,1,2,3,14.999536055771733,#717171
2214,0.00017,2,0,2,17.494431323525504,#6f6f6f
4897,0.000094,0,4,4,12,#737373
2357,0.000094,0,4,4,12,#737373
2215,0.000153,2,0,2,16.382109723928565,#707070
2411,0.000094,0,2,2,12,#737373
2370,0.000094,0,3,3,12,#737373
2216,0.000155,2,0,2,16.515761823530525,#707070
2387,0.000122,1,3,4,14.199095341257646,#717171
2288,0.000216,1,1,2,20.275805650131435,#6d6d6d
2217,0.00038,2,0,2,28.48791670681961,#676767
2345,0.00012,1,1,2,14.050122216323361,#717171
2346,0.000094,0,3,3,12,#737373
2218,0.00016,2,0,2,16.846537660321623,#6f6f6f
2347,0.000094,0,2,2,12,#737373
2219,0.000414,4,0,4,29.97193062100049,#666666
2332,0.000213,2,4,6,20.103098863481684,#6d6d6d
2373,0.000218,1,2,3,20.390344347943245,#6d6d6d
2397,0.000292,3,2,5,24.340542711983574,#6a6a6a
2229,0.000094,0,3,3,12,#737373
2220,0.00012,1,0,1,14.050122216323361,#717171
2222,0.00052,5,1,6,34.277718362723604,#636363
2221,0.001097,9,0,9,52.8286252105379,#575757
2232,0.000109,1,1,2,13.209951757949934,#727272
2261,0.000094,0,1,1,12,#737373
2295,0.000109,1,1,2,13.209951757949934,#727272
2376,0.000133,1,2,3,14.999536055771733,#717171
2402,0.000094,0,2,2,12,#737373
2403,0.000094,0,2,2,12,#737373
2405,0.000094,0,5,5,12,#737373
2224,0.000196,2,1,3,19.102991324867094,#6e6e6e
2321,0.000366,4,5,9,27.85956352259946,#686868
2418,0.000094,0,3,3,12,#737373
2235,0.00044,7,1,8,31.070057997990283,#656565
2383,0.000094,0,5,5,12,#737373
2350,0.000094,0,2,2,12,#737373
2314,0.000196,2,1,3,19.102991324867094,#6e6e6e
2225,0.0003,2,0,2,24.738966688159792,#6a6a6a
2404,0.000094,0,2,2,12,#737373
2228,0.000337,1,1,2,26.52253662605617,#696969
2226,0.00038,1,0,1,28.48791670681961,#676767
2230,0.000224,1,1,2,20.731153739353275,#6d6d6d
2227,0.000323,2,0,2,25.858570168259796,#696969
2359,0.000094,0,2,2,12,#737373
2234,0.000286,1,1,2,24.03849160370686,#6a6a6a
2263,0.000153,2,1,3,16.382109723928565,#707070
2317,0.00012,1,2,3,14.050122216323361,#717171
2305,0.000133,1,1,2,14.999536055771733,#717171
2233,0.001018,3,0,3,50.609943654827504,#585858
2361,0.000094,0,2,2,12,#737373
2409,0.000908,6,1,7,47.38707042569501,#5a5a5a
2360,0.000226,1,1,2,20.843841544046825,#6d6d6d
2262,0.000163,2,4,6,17.042772364524353,#6f6f6f
2298,0.000233,2,4,6,21.234758886801874,#6c6c6c
2309,0.000121,2,1,3,14.124747288633095,#717171
2328,0.000136,2,2,4,15.212609940615039,#717171
2369,0.000094,0,3,3,12,#737373
2238,0.000343,3,2,5,26.803285186298606,#686868
2236,0.000239,1,0,1,21.56564352455313,#6c6c6c
2237,0.000239,1,0,1,21.56564352455313,#6c6c6c
2291,0.000133,1,1,2,14.999536055771733,#717171
2368,0.000186,3,2,5,18.496400996337503,#6e6e6e
2285,0.000346,3,1,4,26.942830456588574,#686868
2239,0.000468,2,0,2,32.220476738241295,#656565
2313,0.000094,0,1,1,12,#737373
2325,0.000235,2,2,4,21.345475258565315,#6c6c6c
2240,0.000233,2,0,2,21.234758886801874,#6c6c6c
2366,0.000094,0,2,2,12,#737373
2242,0.000616,3,1,4,37.84617794545803,#616161
2241,0.000708,3,0,3,41.037409390734396,#5f5f5f
4507,0.00012,1,2,3,14.050122216323361,#717171
4631,0.000094,0,2,2,12,#737373
2249,0.000597,7,2,9,37.16097463850524,#616161
2310,0.000094,0,2,2,12,#737373
2355,0.00027,3,1,4,23.218768698136756,#6b6b6b
2243,0.000421,2,0,2,30.270561055601863,#666666
2335,0.000267,2,1,3,23.0626604244448,#6b6b6b
2315,0.000094,0,2,2,12,#737373
2245,0.00028,2,0,2,23.7335752027898,#6a6a6a
2421,0.000173,1,1,2,17.685431661066666,#6f6f6f
2308,0.000218,2,1,3,20.390344347943245,#6d6d6d
2246,0.00033,3,0,3,26.19213799612306,#696969
2388,0.000094,0,7,7,12,#737373
2420,0.000094,0,2,2,12,#737373
2256,0.000241,1,1,2,21.675105650777578,#6c6c6c
2247,0.000355,2,0,2,27.358232671492853,#686868
2386,0.000133,1,2,3,14.999536055771733,#717171
2248,0.000566,4,0,4,36.02157518058237,#626262
2250,0.000094,0,1,1,12,#737373
4535,0.000094,0,3,3,12,#737373
4536,0.000133,1,1,2,14.999536055771733,#717171
2251,0.000094,0,1,1,12,#737373
2252,0.000094,0,1,1,12,#737373
2253,0.000196,1,1,2,19.102991324867094,#6e6e6e
4573,0.000231,2,2,4,21.123614021758055,#6c6c6c
4652,0.000094,0,6,6,12,#737373
2311,0.00012,1,1,2,14.050122216323361,#717171
2281,0.000554,2,1,3,35.573005228277026,#626262
2254,0.000605,2,0,2,37.45066009326906,#616161
2379,0.000094,0,2,2,12,#737373
2292,0.000094,0,2,2,12,#737373
2255,0.000302,2,0,2,24.8378228436656,#6a6a6a
2327,0.000396,5,2,7,29.193411658840844,#676767
2303,0.000173,2,1,3,17.685431661066666,#6f6f6f
2257,0.00018,2,0,2,18.125388039359912,#6e6e6e
2407,0.000094,0,4,4,12,#737373
2258,0.000128,1,0,1,14.639545810903515,#717171
2259,0.000128,1,0,1,14.639545810903515,#717171
2260,0.000128,1,0,1,14.639545810903515,#717171
2364,0.000094,0,4,4,12,#737373
2306,0.000094,0,2,2,12,#737373
2264,0.0002,2,0,2,19.341713958828393,#6e6e6e
2286,0.000094,0,2,2,12,#737373
2265,0.000182,2,0,2,18.249668885536508,#6e6e6e
4854,0.000113,1,2,3,13.5196994710513,#727272
2272,0.000133,1,1,2,14.999536055771733,#717171
2266,0.000242,2,0,2,21.729683399131453,#6c6c6c
2268,0.000265,3,1,4,22.958149413296184,#6b6b6b
2267,0.000673,5,0,5,39.84670802053496,#5f5f5f
2269,0.000094,0,1,1,12,#737373
2270,0.000094,0,1,1,12,#737373
2333,0.000156,1,1,2,16.582296788749808,#707070
2381,0.000146,1,2,3,15.908016751672154,#707070
2271,0.000094,0,1,1,12,#737373
2416,0.000094,0,2,2,12,#737373
2334,0.000094,0,2,2,12,#737373
2275,0.000094,0,2,2,12,#737373
2273,0.000133,1,0,1,14.999536055771733,#717171
2274,0.000173,3,0,3,17.685431661066666,#6f6f6f
2372,0.000094,0,4,4,12,#737373
2277,0.000094,0,1,1,12,#737373
2276,0.000414,3,0,3,29.97193062100049,#666666
2290,0.000252,3,1,4,22.26998200926203,#6c6c6c
2389,0.000094,0,3,3,12,#737373
2320,0.000156,1,1,2,16.582296788749808,#707070
2278,0.000252,2,0,2,22.26998200926203,#6c6c6c
2371,0.000094,0,3,3,12,#737373
2279,0.000168,2,0,2,17.36625413094873,#6f6f6f
2284,0.000094,0,3,3,12,#737373
2280,0.00012,1,0,1,14.050122216323361,#717171
2336,0.000463,3,1,4,32.01736471555461,#656565
2302,0.000142,1,1,2,15.632508821476176,#707070
2375,0.000094,0,2,2,12,#737373
2331,0.000166,1,1,2,17.237388412297367,#6f6f6f
2392,0.00017,3,2,5,17.494431323525504,#6f6f6f
2287,0.000168,2,0,2,17.36625413094873,#6f6f6f
2316,0.000145,1,1,2,15.839461562490118,#707070
2341,0.000146,1,1,2,15.908016751672154,#707070
2289,0.00027,2,0,2,23.218768698136756,#6b6b6b
2377,0.000094,0,2,2,12,#737373
2348,0.000094,0,2,2,12,#737373
2293,0.000173,2,0,2,17.685431661066666,#6f6f6f
2367,0.000094,0,2,2,12,#737373
2294,0.000191,2,0,2,18.801482814356014,#6e6e6e
2296,0.000143,1,0,1,15.701709764920519,#707070
2297,0.000143,1,0,1,15.701709764920519,#707070
2343,0.000133,1,1,2,14.999536055771733,#717171
2300,0.000113,1,1,2,13.5196994710513,#727272
2299,0.00021,2,0,2,19.929293935525752,#6d6d6d
2301,0.000113,1,0,1,13.5196994710513,#727272
2354,0.000113,1,2,3,13.5196994710513,#727272
2408,0.000094,0,2,2,12,#737373
2330,0.000109,1,1,2,13.209951757949934,#727272
2415,0.000133,1,1,2,14.999536055771733,#717171
4837,0.000094,0,3,3,12,#737373
2318,0.000307,2,0,2,25.083682362465577,#6a6a6a
2319,0.000196,2,0,2,19.102991324867094,#6e6e6e
2322,0.000094,0,1,1,12,#737373
2323,0.000094,0,1,1,12,#737373
2324,0.000094,0,1,1,12,#737373
2358,0.00012,1,1,2,14.050122216323361,#717171
2406,0.000094,0,2,2,12,#737373
2329,0.000094,0,3,3,12,#737373
2326,0.00012,1,0,1,14.050122216323361,#717171
2352,0.000105,1,1,2,12.895045046072177,#727272
2380,0.000105,1,1,2,12.895045046072177,#727272
2349,0.000173,2,1,3,17.685431661066666,#6f6f6f
2338,0.000094,0,1,1,12,#737373
2374,0.000295,2,1,3,24.490520506808657,#6a6a6a
2337,0.000153,2,0,2,16.382109723928565,#707070
2339,0.000145,2,0,2,15.839461562490118,#707070
2419,0.000094,0,2,2,12,#737373
2363,0.000222,2,3,5,20.61801225297066,#6d6d6d
2340,0.000236,2,0,2,21.40067441307267,#6c6c6c
2401,0.000094,0,1,1,12,#737373
2342,0.000196,2,0,2,19.102991324867094,#6e6e6e
4035,0.000094,0,2,2,12,#737373
2353,0.000157,2,0,2,16.648640101132177,#707070
4634,0.00012,1,1,2,14.050122216323361,#717171
2356,0.00019,2,0,2,18.740756670053315,#6e6e6e
2362,0.000156,1,1,2,16.582296788749808,#707070
2365,0.000128,1,1,2,14.639545810903515,#717171
4859,0.00012,1,3,4,14.050122216323361,#717171
2378,0.00019,2,1,3,18.740756670053315,#6e6e6e
2384,0.00012,1,1,2,14.050122216323361,#717171
2385,0.00012,1,1,2,14.050122216323361,#717171
2395,0.000094,0,2,2,12,#737373
2398,0.000094,0,2,2,12,#737373
4660,0.000133,1,4,5,14.999536055771733,#717171
2394,0.000094,0,3,3,12,#737373
2391,0.00012,1,0,1,14.050122216323361,#717171
4849,0.000094,0,2,2,12,#737373
2399,0.000094,0,1,1,12,#737373
2400,0.000094,0,1,1,12,#737373
2410,0.000094,0,1,1,12,#737373
4552,0.00046,3,1,4,31.895023551293622,#656565
4632,0.000133,1,1,2,14.999536055771733,#717171
4649,0.000275,3,2,5,23.477225028974956,#6b6b6b
4749,0.000147,2,2,4,15.97636096389552,#707070
4753,0.00012,1,2,3,14.050122216323361,#717171
4695,0.000248,1,3,4,22.055041569506876,#6c6c6c
2422,0.000094,0,1,1,12,#737373
4491,0.000437,4,1,5,30.944869735648133,#656565
2423,0.000578,2,0,2,36.46588545161213,#626262
4563,0.000133,1,1,2,14.999536055771733,#717171
2425,0.00024,2,1,3,21.620425898203866,#6c6c6c
2424,0.000297,1,0,1,24.590124646255656,#6a6a6a
2459,0.000235,4,2,6,21.345475258565315,#6c6c6c
2519,0.000219,3,4,7,20.447436343276856,#6d6d6d
2485,0.000642,7,1,8,38.76859825791353,#606060
2655,0.000569,5,1,6,36.13304699442957,#626262
2729,0.000173,1,2,3,17.685431661066666,#6f6f6f
2427,0.000241,2,0,2,21.675105650777578,#6c6c6c
2730,0.000173,1,2,3,17.685431661066666,#6f6f6f
2489,0.000352,5,2,7,27.2202975093119,#686868
2428,0.000482,3,0,3,32.78405507641063,#646464
2586,0.000223,2,8,10,20.67464007448106,#6d6d6d
2656,0.000253,2,1,3,22.323476700598142,#6b6b6b
2545,0.000687,7,2,9,40.3262560965538,#5f5f5f
2429,0.000449,2,0,2,31.443336671971757,#656565
2617,0.000524,5,7,12,34.43204364542168,#636363
2595,0.000249,3,6,9,22.108922047173674,#6c6c6c
2430,0.000129,1,0,1,14.712043210723964,#717171
2432,0.000167,1,1,2,17.301908082944657,#6f6f6f
2431,0.000315,2,0,2,25.473340498053965,#696969
2816,0.000094,0,1,1,12,#737373
2590,0.000173,1,2,3,17.685431661066666,#6f6f6f
2578,0.000197,2,1,3,19.16287594224734,#6e6e6e
2433,0.00034,2,0,2,26.66318959447377,#686868
2661,0.000094,0,1,1,12,#737373
2436,0.000361,2,1,3,27.632538684601606,#686868
2434,0.002274,12,0,12,80,#454545
2471,0.00012,1,2,3,14.050122216323361,#717171
2524,0.00022,2,1,3,20.50441114623677,#6d6d6d
2588,0.000094,0,5,5,12,#737373
2619,0.00014,2,1,3,15.493445725621832,#707070
2623,0.000167,1,2,3,17.301908082944657,#6f6f6f
2624,0.000133,1,2,3,14.999536055771733,#717171
2662,0.001278,11,1,12,57.65583828685398,#535353
2668,0.000094,0,3,3,12,#737373
2698,0.000173,1,1,2,17.685431661066666,#6f6f6f
2701,0.000094,0,2,2,12,#737373
2702,0.000173,1,2,3,17.685431661066666,#6f6f6f
2490,0.000795,5,1,6,43.887362892841274,#5d5d5d
2435,0.001078,3,0,3,52.30176893362004,#575757
2638,0.000094,0,3,3,12,#737373
2670,0.000332,4,1,5,26.28685674490043,#696969
2672,0.000287,2,1,3,24.089030084755148,#6a6a6a
2439,0.001825,10,2,12,70.62649283588622,#4b4b4b
2437,0.000869,1,0,1,46.20261249874017,#5b5b5b
2438,0.000869,1,0,1,46.20261249874017,#5b5b5b
2449,0.000722,2,1,3,41.50624756578634,#5e5e5e
2529,0.00049,4,1,5,33.102793916692825,#646464
2596,0.000341,4,4,8,26.70994970428908,#686868
2631,0.000213,2,1,3,20.103098863481684,#6d6d6d
2633,0.00012,1,1,2,14.050122216323361,#717171
2639,0.000094,0,2,2,12,#737373
2682,0.000094,0,1,1,12,#737373
2683,0.000094,0,1,1,12,#737373
2885,0.000173,1,2,3,17.685431661066666,#6f6f6f
2991,0.000173,1,2,3,17.685431661066666,#6f6f6f
4129,0.000253,2,2,4,22.323476700598142,#6b6b6b
2440,0.000304,3,0,3,24.93638483064867,#6a6a6a
4148,0.000173,1,2,3,17.685431661066666,#6f6f6f
2443,0.000268,3,2,5,23.114783806097357,#6b6b6b
2441,0.000207,1,0,1,19.754368044230688,#6d6d6d
2442,0.000207,1,0,1,19.754368044230688,#6d6d6d
2521,0.000303,3,2,5,24.887140432028936,#6a6a6a
2616,0.000113,1,3,4,13.5196994710513,#727272
2627,0.000094,0,6,6,12,#737373
2681,0.000094,0,1,1,12,#737373
2444,0.000482,5,0,5,32.78405507641063,#646464
2685,0.000356,1,2,3,27.4040943973584,#686868
2707,0.000094,0,1,1,12,#737373
2956,0.000133,1,3,4,14.999536055771733,#717171
3094,0.000094,0,2,2,12,#737373
2604,0.000421,4,4,8,30.270561055601863,#666666
2445,0.000414,3,0,3,29.97193062100049,#666666
2708,0.000094,0,1,1,12,#737373
2502,0.000424,5,2,7,30.397860923198664,#666666
2446,0.00041,3,0,3,29.80026414973662,#666666
2559,0.000266,3,4,7,23.01044912007304,#6b6b6b
3206,0.000094,0,1,1,12,#737373
2457,0.000664,5,1,6,39.53605388657749,#606060
2793,0.000113,1,2,3,13.5196994710513,#727272
2814,0.000398,4,1,5,29.28068923771282,#676767
2967,0.00016,2,3,5,16.846537660321623,#6f6f6f
2448,0.000439,2,0,2,31.028371377525648,#656565
2597,0.000125,1,2,3,14.420509920674892,#717171
2687,0.000708,6,1,7,41.037409390734396,#5f5f5f
3189,0.000094,0,3,3,12,#737373
2451,0.000094,0,1,1,12,#737373
2450,0.000454,5,0,5,31.649259069339983,#656565
2576,0.000326,4,2,6,26.00192217315449,#696969
2717,0.000369,5,5,10,27.995108790386844,#676767
2719,0.000094,0,2,2,12,#737373
3043,0.000094,0,2,2,12,#737373
2551,0.000253,1,4,5,22.323476700598142,#6b6b6b
2452,0.00054,3,0,3,35.044110063409036,#636363
2561,0.0003,3,6,9,24.738966688159792,#6a6a6a
2694,0.000412,4,1,5,29.886191135675617,#666666
2454,0.000774,3,1,4,43.21285186840433,#5d5d5d
2453,0.000751,1,0,1,42.46458111431075,#5e5e5e
2560,0.00021,2,1,3,19.929293935525752,#6d6d6d
2697,0.000563,6,1,7,35.909837169872354,#626262
2709,0.000094,0,3,3,12,#737373
2455,0.000246,4,0,4,21.94698647096437,#6c6c6c
2838,0.00021,3,3,6,19.929293935525752,#6d6d6d
3105,0.000094,0,3,3,12,#737373
3228,0.000094,0,2,2,12,#737373
2458,0.000865,7,2,9,46.07978947874666,#5b5b5b
2456,0.000551,3,0,3,35.46018156449842,#626262
2930,0.000094,0,1,1,12,#737373
3004,0.000173,1,3,4,17.685431661066666,#6f6f6f
3011,0.000094,0,3,3,12,#737373
2487,0.000304,2,1,3,24.93638483064867,#6a6a6a
2525,0.000157,1,1,2,16.648640101132177,#707070
2593,0.000401,2,5,7,29.41123641648263,#666666
2677,0.000094,0,3,3,12,#737373
2703,0.000286,3,2,5,24.03849160370686,#6a6a6a
2558,0.000094,0,4,4,12,#737373
2591,0.000094,0,3,3,12,#737373
2599,0.000094,0,3,3,12,#737373
2461,0.000191,2,1,3,18.801482814356014,#6e6e6e
2460,0.000256,1,0,1,22.483392551881522,#6b6b6b
2463,0.000241,2,1,3,21.675105650777578,#6c6c6c
2462,0.000298,1,0,1,24.63981351619035,#6a6a6a
2654,0.000173,1,2,3,17.685431661066666,#6f6f6f
2486,0.000705,3,1,4,40.93640293883049,#5f5f5f
2464,0.000893,4,0,4,46.93427191941788,#5b5b5b
2712,0.000094,0,1,1,12,#737373
2713,0.000094,0,1,1,12,#737373
2716,0.000171,2,1,3,17.5582653966192,#6f6f6f
2465,0.000743,5,0,5,42.201902211675616,#5e5e5e
2939,0.000428,3,1,4,30.566965295087698,#666666
3244,0.00012,1,2,3,14.050122216323361,#717171
3279,0.000094,0,3,3,12,#737373
2466,0.000156,1,0,1,16.582296788749808,#707070
2467,0.000156,1,0,1,16.582296788749808,#707070
2527,0.000704,5,1,6,40.90269115776486,#5f5f5f
2468,0.000814,3,0,3,44.49075772764151,#5c5c5c
2718,0.000094,0,1,1,12,#737373
2469,0.000349,3,0,3,27.081832310819312,#686868
2723,0.000336,1,2,3,26.475527200275646,#696969
2470,0.000145,1,0,1,15.839461562490118,#707070
2966,0.000094,0,3,3,12,#737373
2493,0.000335,6,2,8,26.42845477314982,#696969
2472,0.000331,3,0,3,26.23952956349499,#696969
3216,0.000094,0,1,1,12,#737373
2476,0.000207,1,2,3,19.754368044230688,#6d6d6d
2473,0.000624,3,0,3,38.13183425128131,#606060
2477,0.000133,1,2,3,14.999536055771733,#717171
2645,0.000908,4,2,6,47.38707042569501,#5a5a5a
2475,0.000258,4,1,5,22.58953495795189,#6b6b6b
2474,0.000891,7,0,7,46.873641022414496,#5b5b5b
2483,0.000263,2,1,3,22.85328285153254,#6b6b6b
2552,0.000173,1,2,3,17.685431661066666,#6f6f6f
2642,0.000094,0,1,1,12,#737373
2503,0.000167,1,2,3,17.301908082944657,#6f6f6f
3217,0.000133,1,1,2,14.999536055771733,#717171
3218,0.000094,0,2,2,12,#737373
2810,0.000403,4,3,7,29.498023818295955,#666666
2478,0.000354,2,0,2,27.31231277408949,#686868
2864,0.000343,3,2,5,26.803285186298606,#686868
2480,0.0002,2,1,3,19.341713958828393,#6e6e6e
2479,0.000422,3,0,3,30.313039565996917,#666666
2481,0.000094,0,1,1,12,#737373
2555,0.000094,0,1,1,12,#737373
2482,0.000094,0,1,1,12,#737373
3219,0.000133,1,1,2,14.999536055771733,#717171
2505,0.0011,4,1,5,52.911436479212064,#575757
2484,0.001564,4,0,4,64.69477258459858,#4f4f4f
2736,0.00051,4,1,5,33.889550727488995,#636363
3090,0.00012,1,2,3,14.050122216323361,#717171
3091,0.00012,1,2,3,14.050122216323361,#717171
2496,0.000154,2,1,3,16.449033409962986,#707070
2741,0.000173,1,2,3,17.685431661066666,#6f6f6f
2743,0.000173,1,2,3,17.685431661066666,#6f6f6f
2764,0.000139,2,1,3,15.423579008661793,#707070
2958,0.000094,0,2,2,12,#737373
2528,0.000585,5,1,6,36.723150329799296,#616161
2632,0.000173,1,1,2,17.685431661066666,#6f6f6f
2488,0.000575,5,0,5,36.3552001361638,#626262
2989,0.000094,0,2,2,12,#737373
3214,0.000133,1,1,2,14.999536055771733,#717171
3252,0.000094,0,2,2,12,#737373
2583,0.000094,0,3,3,12,#737373
3060,0.000094,0,2,2,12,#737373
3115,0.000094,0,2,2,12,#737373
2495,0.000332,3,1,4,26.28685674490043,#696969
2498,0.000347,3,1,4,26.989224450772824,#686868
2948,0.000094,0,2,2,12,#737373
3017,0.000094,0,7,7,12,#737373
2759,0.000094,0,2,2,12,#737373
2491,0.000133,1,0,1,14.999536055771733,#717171
2492,0.000644,3,0,3,38.83885100239434,#606060
2643,0.000455,2,2,4,31.69032086435834,#656565
2646,0.000253,2,1,3,22.323476700598142,#6b6b6b
3014,0.000094,0,3,3,12,#737373
3016,0.000094,0,3,3,12,#737373
3224,0.000094,0,1,1,12,#737373
3225,0.000094,0,1,1,12,#737373
2494,0.00024,3,0,3,21.620425898203866,#6c6c6c
2760,0.000328,5,3,8,26.097160568962565,#696969
2761,0.000094,0,1,1,12,#737373
2762,0.000094,0,1,1,12,#737373
2763,0.000094,0,1,1,12,#737373
2766,0.000173,1,3,4,17.685431661066666,#6f6f6f
2497,0.000429,4,0,4,30.609130121369745,#666666
2767,0.000173,1,1,2,17.685431661066666,#6f6f6f
2769,0.000173,1,2,3,17.685431661066666,#6f6f6f
3172,0.000094,0,1,1,12,#737373
2513,0.000125,2,1,3,14.420509920674892,#717171
2538,0.002013,8,1,9,74.66495164069515,#484848
2499,0.002075,3,0,3,75.9591900246468,#484848
2544,0.000448,5,2,7,31.402028585233786,#656565
3078,0.000094,0,1,1,12,#737373
2530,0.000806,7,1,8,44.237477666027445,#5c5c5c
2500,0.001128,6,0,6,53.679496709390335,#565656
2579,0.0002,2,2,4,19.341713958828393,#6e6e6e
2775,0.000094,0,1,1,12,#737373
2776,0.000094,0,1,1,12,#737373
3113,0.000094,0,3,3,12,#737373
3271,0.000094,0,1,1,12,#737373
2501,0.000853,3,0,3,45.709778381468276,#5b5b5b
3226,0.000094,0,1,1,12,#737373
3227,0.000094,0,1,1,12,#737373
2611,0.000261,3,3,6,22.74805681184243,#6b6b6b
2504,0.000319,3,0,3,25.666498776595375,#696969
2609,0.000133,1,2,3,14.999536055771733,#717171
2782,0.000094,0,1,1,12,#737373
2522,0.00082,7,1,8,44.679983412027596,#5c5c5c
2783,0.000302,3,1,4,24.8378228436656,#6a6a6a
2785,0.000094,0,3,3,12,#737373
3049,0.000094,0,3,3,12,#737373
2622,0.000403,3,1,4,29.498023818295955,#666666
2506,0.000595,3,0,3,37.088280827985045,#616161
2777,0.000094,0,1,1,12,#737373
2802,0.000094,0,1,1,12,#737373
2508,0.00022,2,1,3,20.50441114623677,#6d6d6d
2507,0.00028,1,0,1,23.7335752027898,#6a6a6a
2613,0.000094,0,1,1,12,#737373
2510,0.000094,0,1,1,12,#737373
2509,0.000298,4,0,4,24.63981351619035,#6a6a6a
2511,0.000094,0,1,1,12,#737373
3229,0.000113,1,1,2,13.5196994710513,#727272
2512,0.00019,1,0,1,18.740756670053315,#6e6e6e
2795,0.000094,0,4,4,12,#737373
2515,0.000362,4,1,5,27.678056297441284,#686868
2514,0.000437,2,0,2,30.944869735648133,#656565
3036,0.000094,0,2,2,12,#737373
3231,0.000094,0,1,1,12,#737373
2517,0.000094,0,1,1,12,#737373
2516,0.000299,3,0,3,24.689427409048697,#6a6a6a
2518,0.000094,0,1,1,12,#737373
2602,0.000094,0,1,1,12,#737373
2533,0.00129,9,1,10,57.96462324727506,#535353
2520,0.0013,3,0,3,58.220957965347466,#535353
3005,0.000355,4,4,8,27.358232671492853,#686868
2641,0.000173,1,2,3,17.685431661066666,#6f6f6f
3233,0.000094,0,1,1,12,#737373
2601,0.000259,3,2,5,22.642467293054047,#6b6b6b
2614,0.000304,2,1,3,24.93638483064867,#6a6a6a
2806,0.00019,2,2,4,18.740756670053315,#6e6e6e
2807,0.000173,1,1,2,17.685431661066666,#6f6f6f
3045,0.000094,0,2,2,12,#737373
3047,0.000094,0,3,3,12,#737373
2523,0.000167,1,0,1,17.301908082944657,#6f6f6f
2813,0.000363,4,3,7,27.72351736267923,#686868
3234,0.000162,2,1,3,16.977542788511858,#6f6f6f
2526,0.000231,1,0,1,21.123614021758055,#6c6c6c
2600,0.000173,1,1,2,17.685431661066666,#6f6f6f
2789,0.000094,0,2,2,12,#737373
2804,0.000173,1,2,3,17.685431661066666,#6f6f6f
2815,0.000362,4,1,5,27.678056297441284,#686868
2549,0.000306,3,2,5,25.034655451212537,#6a6a6a
2606,0.000799,4,3,7,44.014928078955485,#5d5d5d
2612,0.000094,0,4,4,12,#737373
2554,0.000896,7,3,10,47.025103810313404,#5a5a5a
2874,0.000221,3,2,5,20.56126952844315,#6d6d6d
2917,0.000111,1,3,4,13.365453519669122,#727272
3186,0.00012,1,6,7,14.050122216323361,#717171
2531,0.000425,3,1,4,30.44020407932667,#666666
2792,0.000178,2,2,4,18.000484217107044,#6f6f6f
2916,0.000227,2,3,5,20.900017136346257,#6c6c6c
2918,0.000354,4,5,9,27.31231277408949,#686868
3181,0.000094,0,2,2,12,#737373
2636,0.000133,1,1,2,14.999536055771733,#717171
2725,0.00019,2,1,3,18.740756670053315,#6e6e6e
2726,0.000133,1,2,3,14.999536055771733,#717171
2532,0.000162,2,0,2,16.977542788511858,#6f6f6f
2534,0.000637,5,1,6,38.59253424263456,#606060
2765,0.00012,1,3,4,14.050122216323361,#717171
2821,0.000173,1,2,3,17.685431661066666,#6f6f6f
2823,0.000173,1,2,3,17.685431661066666,#6f6f6f
3112,0.000094,0,3,3,12,#737373
3179,0.000094,0,2,2,12,#737373
2564,0.00032,2,1,3,25.714617749683157,#696969
2659,0.000133,1,1,2,14.999536055771733,#717171
2536,0.000386,2,1,3,28.754015449673606,#676767
2535,0.000421,1,0,1,30.270561055601863,#666666
2629,0.000297,3,1,4,24.590124646255656,#6a6a6a
2537,0.000395,3,0,3,29.149698491158492,#676767
2841,0.000226,2,1,3,20.843841544046825,#6d6d6d
3055,0.000094,0,2,2,12,#737373
2539,0.00045,2,1,3,31.48460337932012,#656565
2550,0.000947,6,1,7,48.548846280960014,#595959
2920,0.000094,0,2,2,12,#737373
3123,0.000114,1,1,2,13.596361604606898,#727272
3124,0.000114,1,1,2,13.596361604606898,#727272
2828,0.000094,0,3,3,12,#737373
2540,0.00012,1,0,1,14.050122216323361,#717171
2541,0.000147,2,0,2,15.97636096389552,#707070
2728,0.000289,4,1,5,24.189869906310776,#6a6a6a
2952,0.000213,2,5,7,20.103098863481684,#6d6d6d
2997,0.00012,1,4,5,14.050122216323361,#717171
3068,0.000094,0,1,1,12,#737373
3174,0.000173,1,4,5,17.685431661066666,#6f6f6f
3207,0.000094,0,2,2,12,#737373
4219,0.000094,0,3,3,12,#737373
2791,0.000196,2,1,3,19.102991324867094,#6e6e6e
2843,0.000151,2,3,5,16.24766909105304,#707070
2844,0.000094,0,1,1,12,#737373
2923,0.000094,0,3,3,12,#737373
2592,0.000094,0,2,2,12,#737373
2637,0.000094,0,2,2,12,#737373
2858,0.000173,1,2,3,17.685431661066666,#6f6f6f
2860,0.000173,1,2,3,17.685431661066666,#6f6f6f
2862,0.000173,1,2,3,17.685431661066666,#6f6f6f
3154,0.000094,0,2,2,12,#737373
2546,0.000163,1,0,1,17.042772364524353,#6f6f6f
2547,0.000163,1,0,1,17.042772364524353,#6f6f6f
2847,0.000186,1,1,2,18.496400996337503,#6e6e6e
2848,0.000094,0,1,1,12,#737373
2855,0.000094,0,1,1,12,#737373
2856,0.000094,0,1,1,12,#737373
2849,0.000352,1,1,2,27.2202975093119,#686868
2850,0.000352,1,1,2,27.2202975093119,#686868
2853,0.000094,0,1,1,12,#737373
2854,0.000094,0,1,1,12,#737373
2852,0.000375,6,2,8,28.26472010998426,#676767
3292,0.000094,0,1,1,12,#737373
2721,0.000237,1,1,2,21.455768414852855,#6c6c6c
2553,0.001514,19,0,19,63.508858540099425,#505050
2801,0.00022,3,1,4,20.50441114623677,#6d6d6d
2809,0.000136,1,1,2,15.212609940615039,#717171
2845,0.000129,1,1,2,14.712043210723964,#717171
2870,0.000173,1,2,3,17.685431661066666,#6f6f6f
2871,0.000173,1,2,3,17.685431661066666,#6f6f6f
2872,0.000173,1,2,3,17.685431661066666,#6f6f6f
2908,0.00018,2,5,7,18.125388039359912,#6e6e6e
2922,0.000173,1,2,3,17.685431661066666,#6f6f6f
2971,0.000165,1,4,5,17.17269360034772,#6f6f6f
2995,0.000094,0,2,2,12,#737373
2999,0.000094,0,1,1,12,#737373
3096,0.000094,0,3,3,12,#737373
3128,0.000169,3,7,10,17.430428052850882,#6f6f6f
3141,0.000107,1,1,2,13.05316063235918,#727272
3149,0.000094,0,2,2,12,#737373
3284,0.000094,0,6,6,12,#737373
2575,0.000875,11,2,13,46.386371031308705,#5b5b5b
2608,0.000521,6,4,10,34.31634961942269,#636363
3187,0.000094,0,3,3,12,#737373
2621,0.000185,3,1,4,18.434943664037807,#6e6e6e
2556,0.000491,3,0,3,33.14247108015606,#646464
4099,0.000539,2,2,4,35.00609707515816,#636363
4317,0.000094,0,7,7,12,#737373
3242,0.000094,0,1,1,12,#737373
3243,0.000094,0,1,1,12,#737373
2882,0.000094,0,3,3,12,#737373
2826,0.000105,1,1,2,12.895045046072177,#727272
2883,0.000256,4,5,9,22.483392551881522,#6b6b6b
2900,0.000173,1,2,3,17.685431661066666,#6f6f6f
2620,0.000205,2,1,3,19.63711638898998,#6d6d6d
2563,0.000387,4,0,4,28.79818377446482,#676767
2790,0.000094,0,2,2,12,#737373
3146,0.000094,0,2,2,12,#737373
3147,0.000094,0,2,2,12,#737373
2658,0.000173,1,1,2,17.685431661066666,#6f6f6f
2892,0.000094,0,1,1,12,#737373
2565,0.00038,4,0,4,28.48791670681961,#676767
2817,0.000173,1,1,2,17.685431661066666,#6f6f6f
2894,0.000094,0,2,2,12,#737373
2941,0.000173,1,2,3,17.685431661066666,#6f6f6f
2567,0.000235,2,1,3,21.345475258565315,#6c6c6c
2566,0.000294,1,0,1,24.440604495500473,#6a6a6a
2895,0.000094,0,2,2,12,#737373
2568,0.000133,1,0,1,14.999536055771733,#717171
2569,0.000349,3,0,3,27.081832310819312,#686868
2666,0.000173,1,1,2,17.685431661066666,#6f6f6f
2896,0.000241,1,2,3,21.675105650777578,#6c6c6c
2570,0.000196,1,0,1,19.102991324867094,#6e6e6e
2898,0.000094,0,2,2,12,#737373
2571,0.000133,1,0,1,14.999536055771733,#717171
2572,0.000241,3,0,3,21.675105650777578,#6c6c6c
2899,0.000094,0,2,2,12,#737373
2573,0.000133,1,0,1,14.999536055771733,#717171
2574,0.001288,8,0,8,57.91324913456596,#535353
2692,0.000418,5,1,6,30.14285232234559,#666666
2812,0.000094,0,1,1,12,#737373
2906,0.000094,0,1,1,12,#737373
2936,0.000387,5,5,10,28.79818377446482,#676767
2972,0.000094,0,3,3,12,#737373
3097,0.000167,1,1,2,17.301908082944657,#6f6f6f
3281,0.000173,1,2,3,17.685431661066666,#6f6f6f
2581,0.000094,0,1,1,12,#737373
2733,0.000173,1,2,3,17.685431661066666,#6f6f6f
2794,0.000173,1,2,3,17.685431661066666,#6f6f6f
2904,0.000094,0,1,1,12,#737373
2905,0.000094,0,1,1,12,#737373
2907,0.000094,0,1,1,12,#737373
2964,0.000173,1,2,3,17.685431661066666,#6f6f6f
3205,0.000133,1,1,2,14.999536055771733,#717171
3277,0.000094,0,2,2,12,#737373
2577,0.000329,5,0,5,26.14468175968276,#696969
3247,0.000094,0,2,2,12,#737373
3248,0.000094,0,1,1,12,#737373
2902,0.000094,0,1,1,12,#737373
2580,0.000094,0,1,1,12,#737373
2582,0.00012,1,0,1,14.050122216323361,#717171
2584,0.000307,3,0,3,25.083682362465577,#6a6a6a
2585,0.00112,13,0,13,53.4609351060347,#565656
2674,0.000267,3,2,5,23.0626604244448,#6b6b6b
2710,0.00016,2,2,4,16.846537660321623,#6f6f6f
2720,0.000094,0,2,2,12,#737373
2722,0.00043,4,1,5,30.65125074195286,#666666
2880,0.000346,6,2,8,26.942830456588574,#686868
2889,0.000094,0,4,4,12,#737373
2911,0.000094,0,2,2,12,#737373
3095,0.000094,0,2,2,12,#737373
3158,0.000094,0,2,2,12,#737373
3199,0.000094,0,2,2,12,#737373
3215,0.000094,0,3,3,12,#737373
2587,0.000109,1,0,1,13.209951757949934,#727272
3251,0.000113,1,2,3,13.5196994710513,#727272
2589,0.000142,1,0,1,15.632508821476176,#707070
2912,0.000094,0,1,1,12,#737373
2704,0.000275,2,1,3,23.477225028974956,#6b6b6b
2909,0.000173,1,2,3,17.685431661066666,#6f6f6f
2605,0.000464,3,1,4,32.058065782639574,#656565
3157,0.000094,0,2,2,12,#737373
2927,0.000173,1,2,3,17.685431661066666,#6f6f6f
2928,0.000173,1,2,3,17.685431661066666,#6f6f6f
2934,0.000094,0,2,2,12,#737373
2598,0.00012,1,0,1,14.050122216323361,#717171
2933,0.000094,0,1,1,12,#737373
2603,0.000357,3,0,3,27.449898188471693,#686868
2943,0.000133,1,1,2,14.999536055771733,#717171
2953,0.000173,1,2,3,17.685431661066666,#6f6f6f
2955,0.000188,2,1,3,18.618871286344486,#6e6e6e
2618,0.000167,1,2,3,17.301908082944657,#6f6f6f
2607,0.000636,7,1,8,38.55724690698436,#606060
2960,0.000173,1,2,3,17.685431661066666,#6f6f6f
2959,0.00047,5,4,9,32.3014479342237,#646464
3188,0.000133,1,3,4,14.999536055771733,#717171
2651,0.000173,1,1,2,17.685431661066666,#6f6f6f
2963,0.000094,0,2,2,12,#737373
2640,0.00016,2,1,3,16.846537660321623,#6f6f6f
2610,0.000229,1,0,1,21.012035273453705,#6c6c6c
3288,0.000173,1,2,3,17.685431661066666,#6f6f6f
3289,0.000173,1,2,3,17.685431661066666,#6f6f6f
2970,0.000173,1,1,2,17.685431661066666,#6f6f6f
2615,0.000126,1,0,1,14.493782114686502,#717171
3266,0.000094,0,4,4,12,#737373
2886,0.0002,2,1,3,19.341713958828393,#6e6e6e
2973,0.000173,1,2,3,17.685431661066666,#6f6f6f
2974,0.000173,1,2,3,17.685431661066666,#6f6f6f
2976,0.000094,0,4,4,12,#737373
2978,0.000253,2,3,5,22.323476700598142,#6b6b6b
4172,0.000239,3,5,8,21.56564352455313,#6c6c6c
4265,0.000094,0,2,2,12,#737373
2993,0.000247,2,1,3,22.0010632357656,#6c6c6c
2979,0.000173,1,2,3,17.685431661066666,#6f6f6f
2980,0.000094,0,2,2,12,#737373
2625,0.000107,1,0,1,13.05316063235918,#727272
2626,0.000107,1,0,1,13.05316063235918,#727272
2982,0.000094,0,2,2,12,#737373
2628,0.00016,2,0,2,16.846537660321623,#6f6f6f
2990,0.000094,0,3,3,12,#737373
2986,0.0002,2,4,6,19.341713958828393,#6e6e6e
2987,0.000143,1,1,2,15.701709764920519,#707070
3272,0.000094,0,2,2,12,#737373
2630,0.000133,1,0,1,14.999536055771733,#717171
2634,0.000094,0,1,1,12,#737373
3283,0.000094,0,2,2,12,#737373
3204,0.000094,0,1,1,12,#737373
2635,0.00012,1,0,1,14.050122216323361,#717171
2965,0.000094,0,2,2,12,#737373
3208,0.000094,0,1,1,12,#737373
2644,0.000332,3,1,4,26.28685674490043,#696969
3212,0.000094,0,1,1,12,#737373
2648,0.00028,2,3,5,23.7335752027898,#6a6a6a
3236,0.000094,0,1,1,12,#737373
3237,0.000094,0,1,1,12,#737373
2647,0.000678,7,1,8,40.01848595058884,#5f5f5f
3239,0.000094,0,1,1,12,#737373
3240,0.000094,0,1,1,12,#737373
3254,0.000094,0,1,1,12,#737373
2649,0.000253,2,2,4,22.323476700598142,#6b6b6b
3255,0.000094,0,1,1,12,#737373
3256,0.000094,0,1,1,12,#737373
3257,0.000094,0,1,1,12,#737373
3258,0.000094,0,1,1,12,#737373
3259,0.000094,0,1,1,12,#737373
3260,0.000094,0,1,1,12,#737373
3261,0.000094,0,1,1,12,#737373
3273,0.000094,0,1,1,12,#737373
3274,0.000094,0,1,1,12,#737373
2650,0.000241,2,0,2,21.675105650777578,#6c6c6c
3114,0.000094,0,1,1,12,#737373
2652,0.000206,2,0,2,19.695806249957098,#6d6d6d
3040,0.000094,0,1,1,12,#737373
2653,0.000211,2,0,2,19.987352319632762,#6d6d6d
3019,0.000094,0,1,1,12,#737373
2740,0.000419,6,2,8,30.18546759115748,#666666
2825,0.000304,4,2,6,24.93638483064867,#6a6a6a
3176,0.000094,0,1,1,12,#737373
3178,0.000094,0,2,2,12,#737373
2669,0.000094,0,1,1,12,#737373
3155,0.000094,0,1,1,12,#737373
2693,0.00028,4,1,5,23.7335752027898,#6a6a6a
2657,0.000527,5,0,5,34.547439986391424,#636363
3077,0.000094,0,2,2,12,#737373
2667,0.000094,0,1,1,12,#737373
3024,0.000263,1,1,2,22.85328285153254,#6b6b6b
2660,0.000357,2,0,2,27.449898188471693,#686868
3201,0.000094,0,2,2,12,#737373
2684,0.000196,1,1,2,19.102991324867094,#6e6e6e
2705,0.000094,0,1,1,12,#737373
2819,0.000549,6,1,7,35.384812163377326,#626262
2837,0.000262,4,3,7,22.800715014747656,#6b6b6b
2944,0.000226,3,3,6,20.843841544046825,#6d6d6d
2969,0.00012,1,2,3,14.050122216323361,#717171
3104,0.000094,0,3,3,12,#737373
3200,0.000094,0,3,3,12,#737373
2663,0.00012,1,0,1,14.050122216323361,#717171
2664,0.000203,1,0,1,19.51934882871322,#6d6d6d
2665,0.000203,1,0,1,19.51934882871322,#6d6d6d
2788,0.000094,0,1,1,12,#737373
3008,0.000273,3,2,5,23.374098358988334,#6b6b6b
3221,0.000094,0,3,3,12,#737373
2780,0.000271,3,2,5,23.270631146211333,#6b6b6b
2671,0.000674,6,0,6,39.881109429399764,#5f5f5f
2796,0.00031,4,1,5,25.230333578472866,#696969
3001,0.000173,2,2,4,17.685431661066666,#6f6f6f
3026,0.000094,0,2,2,12,#737373
3143,0.000094,0,2,2,12,#737373
2673,0.000094,0,1,1,12,#737373
2890,0.000094,0,1,1,12,#737373
2914,0.000251,4,2,6,22.21639170604164,#6c6c6c
2675,0.0002,1,0,1,19.341713958828393,#6e6e6e
2676,0.00012,1,0,1,14.050122216323361,#717171
2714,0.000113,1,1,2,13.5196994710513,#727272
2678,0.00021,2,0,2,19.929293935525752,#6d6d6d
2942,0.000094,0,4,4,12,#737373
2679,0.000205,1,0,1,19.63711638898998,#6d6d6d
2984,0.0002,2,1,3,19.341713958828393,#6e6e6e
2686,0.000309,2,1,3,25.18152108960815,#696969
2778,0.000223,1,1,2,20.67464007448106,#6d6d6d
3003,0.000094,0,3,3,12,#737373
2758,0.000133,1,1,2,14.999536055771733,#717171
2846,0.000571,7,2,9,36.207214654719394,#626262
3050,0.000133,1,1,2,14.999536055771733,#717171
3098,0.000094,0,2,2,12,#737373
3099,0.000094,0,2,2,12,#737373
2688,0.000145,1,0,1,15.839461562490118,#707070
2689,0.000145,1,0,1,15.839461562490118,#707070
2691,0.000284,3,1,4,23.937175492264057,#6a6a6a
2690,0.000335,1,0,1,26.42845477314982,#696969
2891,0.000113,1,1,2,13.5196994710513,#727272
3145,0.000133,1,1,2,14.999536055771733,#717171
3180,0.000094,0,2,2,12,#737373
3262,0.000094,0,1,1,12,#737373
3171,0.000113,1,1,2,13.5196994710513,#727272
3286,0.000094,0,4,4,12,#737373
2921,0.000094,0,1,1,12,#737373
3021,0.000094,0,1,1,12,#737373
3022,0.000094,0,1,1,12,#737373
3029,0.000094,0,1,1,12,#737373
2695,0.000167,1,0,1,17.301908082944657,#6f6f6f
2696,0.000291,2,0,2,24.290396179232058,#6a6a6a
2787,0.000268,2,3,5,23.114783806097357,#6b6b6b
2881,0.000299,4,2,6,24.689427409048697,#6a6a6a
3093,0.000094,0,1,1,12,#737373
3133,0.000171,2,1,3,17.5582653966192,#6f6f6f
3134,0.00012,1,2,3,14.050122216323361,#717171
3190,0.000094,0,2,2,12,#737373
3270,0.000094,0,3,3,12,#737373
2699,0.000094,0,1,1,12,#737373
2700,0.0002,2,0,2,19.341713958828393,#6e6e6e
3268,0.000094,0,1,1,12,#737373
3067,0.000094,0,1,1,12,#737373
2745,0.000113,1,1,2,13.5196994710513,#727272
3012,0.000094,0,4,4,12,#737373
3103,0.000094,0,1,1,12,#737373
2706,0.000289,2,0,2,24.189869906310776,#6a6a6a
2840,0.000286,3,3,6,24.03849160370686,#6a6a6a
2957,0.000133,1,2,3,14.999536055771733,#717171
2711,0.000349,4,0,4,27.081832310819312,#686868
3210,0.000094,0,1,1,12,#737373
3220,0.000094,0,1,1,12,#737373
3263,0.000094,0,2,2,12,#737373
2811,0.000129,1,1,2,14.712043210723964,#717171
2715,0.000389,4,0,4,28.88636662954051,#676767
3057,0.000094,0,1,1,12,#737373
4022,0.000137,1,1,2,15.283163521922663,#717171
4023,0.000094,0,2,2,12,#737373
2757,0.000113,1,1,2,13.5196994710513,#727272
2755,0.000094,0,1,1,12,#737373
2724,0.000545,7,0,7,35.233701730816236,#626262
2756,0.00013,1,1,2,14.784288150134541,#717171
2779,0.00023,3,2,5,21.067879224360784,#6c6c6c
2839,0.00019,2,4,6,18.740756670053315,#6e6e6e
2857,0.000173,1,4,5,17.685431661066666,#6f6f6f
3061,0.000094,0,2,2,12,#737373
2781,0.000359,4,3,7,27.541332905479567,#686868
2727,0.000382,3,0,3,28.57682498606312,#676767
3009,0.000253,2,2,4,22.323476700598142,#6b6b6b
3287,0.000094,0,1,1,12,#737373
3062,0.000094,0,1,1,12,#737373
3265,0.000094,0,2,2,12,#737373
2731,0.000094,0,1,1,12,#737373
2732,0.000094,0,1,1,12,#737373
3064,0.000094,0,1,1,12,#737373
2738,0.000094,0,3,3,12,#737373
2734,0.00012,1,0,1,14.050122216323361,#717171
2827,0.00012,1,1,2,14.050122216323361,#717171
2735,0.000196,1,0,1,19.102991324867094,#6e6e6e
2737,0.000297,3,1,4,24.590124646255656,#6a6a6a
3010,0.000133,1,2,3,14.999536055771733,#717171
3193,0.000094,0,1,1,12,#737373
2739,0.000345,2,0,2,26.89637608403669,#686868
2932,0.000328,5,3,8,26.097160568962565,#696969
3041,0.00012,1,5,6,14.050122216323361,#717171
3042,0.000094,0,3,3,12,#737373
2742,0.000094,0,1,1,12,#737373
2744,0.000094,0,1,1,12,#737373
3081,0.000094,0,2,2,12,#737373
2746,0.000133,1,0,1,14.999536055771733,#717171
3082,0.00012,1,1,2,14.050122216323361,#717171
2747,0.000196,1,0,1,19.102991324867094,#6e6e6e
3083,0.000094,0,2,2,12,#737373
2748,0.000133,1,0,1,14.999536055771733,#717171
3084,0.000094,0,2,2,12,#737373
2749,0.000133,1,0,1,14.999536055771733,#717171
3085,0.000094,0,2,2,12,#737373
2750,0.000133,1,0,1,14.999536055771733,#717171
3086,0.000094,0,2,2,12,#737373
2751,0.000133,1,0,1,14.999536055771733,#717171
3087,0.00012,1,1,2,14.050122216323361,#717171
2752,0.000196,1,0,1,19.102991324867094,#6e6e6e
3088,0.000094,0,2,2,12,#737373
2753,0.000133,1,0,1,14.999536055771733,#717171
3089,0.000094,0,2,2,12,#737373
2754,0.000133,1,0,1,14.999536055771733,#717171
2878,0.000246,4,3,7,21.94698647096437,#6c6c6c
3100,0.000094,0,1,1,12,#737373
2768,0.000094,0,1,1,12,#737373
2770,0.000094,0,1,1,12,#737373
2772,0.000094,0,1,1,12,#737373
2771,0.00039,3,0,3,28.930381542039342,#676767
3002,0.000094,0,2,2,12,#737373
2773,0.000133,1,0,1,14.999536055771733,#717171
2981,0.00012,1,2,3,14.050122216323361,#717171
2774,0.000171,2,0,2,17.5582653966192,#6f6f6f
2842,0.000304,3,2,5,24.93638483064867,#6a6a6a
2968,0.000094,0,2,2,12,#737373
2784,0.00012,1,1,2,14.050122216323361,#717171
3076,0.000094,0,1,1,12,#737373
2786,0.00017,1,0,1,17.494431323525504,#6f6f6f
2977,0.000318,3,2,5,25.61831187604224,#696969
3267,0.000094,0,2,2,12,#737373
3108,0.000094,0,1,1,12,#737373
3110,0.000094,0,1,1,12,#737373
3152,0.000133,1,2,3,14.999536055771733,#717171
2798,0.000534,7,1,8,34.81555417287788,#636363
2797,0.000762,3,0,3,42.82371739856607,#5d5d5d
2800,0.000478,7,3,10,32.62379314315763,#646464
3175,0.000094,0,1,1,12,#737373
2820,0.000314,3,2,5,25.424878764011332,#696969
3150,0.000094,0,2,2,12,#737373
3211,0.000094,0,3,3,12,#737373
3222,0.000094,0,2,2,12,#737373
3253,0.000094,0,2,2,12,#737373
2946,0.000094,0,1,1,12,#737373
2947,0.000094,0,1,1,12,#737373
3151,0.000094,0,1,1,12,#737373
2803,0.000133,1,0,1,14.999536055771733,#717171
2805,0.000094,0,1,1,12,#737373
3238,0.000094,0,2,2,12,#737373
3168,0.000094,0,1,1,12,#737373
2808,0.000223,1,0,1,20.67464007448106,#6d6d6d
2903,0.000113,1,1,2,13.5196994710513,#727272
3079,0.000133,1,1,2,14.999536055771733,#717171
3116,0.000094,0,2,2,12,#737373
2983,0.000247,2,2,4,22.0010632357656,#6c6c6c
3106,0.000094,0,1,1,12,#737373
3142,0.000094,0,1,1,12,#737373
3198,0.000094,0,2,2,12,#737373
2818,0.000094,0,1,1,12,#737373
2866,0.000193,1,1,2,18.92250746755846,#6e6e6e
3131,0.000094,0,3,3,12,#737373
2865,0.00013,1,2,3,14.784288150134541,#717171
2822,0.000094,0,1,1,12,#737373
2824,0.000094,0,1,1,12,#737373
3177,0.000094,0,1,1,12,#737373
2829,0.00012,1,0,1,14.050122216323361,#717171
2830,0.00012,1,0,1,14.050122216323361,#717171
2831,0.00012,1,0,1,14.050122216323361,#717171
2833,0.000094,0,1,1,12,#737373
3250,0.000094,0,2,2,12,#737373
3025,0.000094,0,1,1,12,#737373
2935,0.000094,0,2,2,12,#737373
2940,0.000094,0,1,1,12,#737373
3195,0.000094,0,1,1,12,#737373
3018,0.000154,2,1,3,16.449033409962986,#707070
3173,0.00012,1,3,4,14.050122216323361,#717171
3213,0.000094,0,3,3,12,#737373
2851,0.000608,8,2,10,37.55884727414517,#616161
2937,0.000217,2,2,4,20.333134379934826,#6d6d6d
3038,0.000109,1,2,3,13.209951757949934,#727272
3126,0.00012,1,2,3,14.050122216323361,#717171
3130,0.000094,0,3,3,12,#737373
3156,0.000094,0,5,5,12,#737373
3276,0.000094,0,5,5,12,#737373
3275,0.000109,1,1,2,13.209951757949934,#727272
3278,0.000094,0,1,1,12,#737373
3080,0.000094,0,1,1,12,#737373
2859,0.000094,0,1,1,12,#737373
2861,0.000094,0,1,1,12,#737373
2863,0.000094,0,1,1,12,#737373
3028,0.000143,1,1,2,15.701709764920519,#707070
3120,0.000094,0,1,1,12,#737373
3122,0.000173,1,3,4,17.685431661066666,#6f6f6f
2867,0.000113,1,0,1,13.5196994710513,#727272
3135,0.000094,0,2,2,12,#737373
2868,0.000133,1,0,1,14.999536055771733,#717171
3136,0.00012,1,1,2,14.050122216323361,#717171
2869,0.000196,1,0,1,19.102991324867094,#6e6e6e
2876,0.000094,0,1,1,12,#737373
2877,0.000094,0,1,1,12,#737373
2873,0.000094,0,1,1,12,#737373
2875,0.000094,0,1,1,12,#737373
3153,0.000094,0,3,3,12,#737373
2879,0.00036,3,0,3,27.586964296887757,#686868
3111,0.000163,1,2,3,17.042772364524353,#6f6f6f
3117,0.000247,2,3,5,22.0010632357656,#6c6c6c
2998,0.00014,2,1,3,15.493445725621832,#707070
3197,0.00012,1,5,6,14.050122216323361,#717171
3230,0.000094,0,3,3,12,#737373
3058,0.000094,0,1,1,12,#737373
2884,0.000253,3,0,3,22.323476700598142,#6b6b6b
2887,0.000094,0,1,1,12,#737373
2888,0.000094,0,1,1,12,#737373
2893,0.000366,4,0,4,27.85956352259946,#686868
2996,0.000133,1,1,2,14.999536055771733,#717171
3000,0.000094,0,1,1,12,#737373
3245,0.000094,0,2,2,12,#737373
2897,0.000173,1,1,2,17.685431661066666,#6f6f6f
3023,0.000094,0,1,1,12,#737373
2901,0.000094,0,1,1,12,#737373
2910,0.000094,0,1,1,12,#737373
2913,0.00012,1,0,1,14.050122216323361,#717171
3280,0.000094,0,1,1,12,#737373
2915,0.000213,2,0,2,20.103098863481684,#6d6d6d
3138,0.000094,0,1,1,12,#737373
2926,0.000173,1,2,3,17.685431661066666,#6f6f6f
3167,0.000094,0,2,2,12,#737373
2919,0.000133,1,0,1,14.999536055771733,#717171
3051,0.000094,0,1,1,12,#737373
2925,0.000094,0,1,1,12,#737373
2924,0.000373,3,0,3,28.175066819207885,#676767
2938,0.000253,2,2,4,22.323476700598142,#6b6b6b
2929,0.000094,0,1,1,12,#737373
3163,0.000094,0,1,1,12,#737373
3164,0.000094,0,1,1,12,#737373
2931,0.00012,1,0,1,14.050122216323361,#717171
3020,0.00013,1,1,2,14.784288150134541,#717171
3033,0.000133,1,1,2,14.999536055771733,#717171
3034,0.000094,0,2,2,12,#737373
3241,0.000094,0,1,1,12,#737373
2994,0.000094,0,1,1,12,#737373
3140,0.000094,0,1,1,12,#737373
3169,0.000094,0,1,1,12,#737373
3223,0.000094,0,1,1,12,#737373
4024,0.000206,1,1,2,19.695806249957098,#6d6d6d
3170,0.000094,0,1,1,12,#737373
2945,0.000094,0,1,1,12,#737373
2950,0.000094,0,1,1,12,#737373
2951,0.000119,1,0,1,13.975216770645698,#727272
3035,0.000094,0,1,1,12,#737373
2954,0.000094,0,1,1,12,#737373
3063,0.000171,2,1,3,17.5582653966192,#6f6f6f
3109,0.00012,1,2,3,14.050122216323361,#717171
3121,0.000133,1,1,2,14.999536055771733,#717171
3148,0.000094,0,3,3,12,#737373
3161,0.000094,0,2,2,12,#737373
2961,0.000094,0,1,1,12,#737373
2962,0.000133,1,0,1,14.999536055771733,#717171
3066,0.000094,0,1,1,12,#737373
3132,0.000094,0,1,1,12,#737373
3052,0.000094,0,1,1,12,#737373
2975,0.000094,0,1,1,12,#737373
3203,0.000094,0,1,1,12,#737373
3191,0.000094,0,1,1,12,#737373
3192,0.000094,0,1,1,12,#737373
3054,0.000094,0,1,1,12,#737373
3232,0.000133,1,1,2,14.999536055771733,#717171
3235,0.000094,0,2,2,12,#737373
2985,0.000094,0,1,1,12,#737373
3107,0.000094,0,1,1,12,#737373
2988,0.00012,1,0,1,14.050122216323361,#717171
3196,0.000094,0,1,1,12,#737373
2992,0.000114,1,0,1,13.596361604606898,#727272
3118,0.000133,1,1,2,14.999536055771733,#717171
3119,0.000094,0,2,2,12,#737373
3125,0.000094,0,1,1,12,#737373
3056,0.000094,0,1,1,12,#737373
3007,0.000133,1,1,2,14.999536055771733,#717171
3006,0.000207,1,0,1,19.754368044230688,#6d6d6d
3209,0.000133,1,1,2,14.999536055771733,#717171
3269,0.000094,0,2,2,12,#737373
3165,0.000094,0,1,1,12,#737373
3264,0.000094,0,1,1,12,#737373
3013,0.00012,1,0,1,14.050122216323361,#717171
3015,0.00012,1,0,1,14.050122216323361,#717171
3071,0.0002,3,1,4,19.341713958828393,#6e6e6e
3048,0.000094,0,1,1,12,#737373
3027,0.0002,2,0,2,19.341713958828393,#6e6e6e
3030,0.00015,3,0,3,16.180148347028588,#707070
3129,0.000107,1,4,5,13.05316063235918,#727272
3101,0.000094,0,3,3,12,#737373
3031,0.00012,1,0,1,14.050122216323361,#717171
3102,0.000094,0,3,3,12,#737373
3032,0.00012,1,0,1,14.050122216323361,#717171
3037,0.000114,1,0,1,13.596361604606898,#727272
3039,0.00012,1,0,1,14.050122216323361,#717171
3044,0.000216,3,0,3,20.275805650131435,#6d6d6d
3075,0.000133,1,2,3,14.999536055771733,#717171
3137,0.000094,0,3,3,12,#737373
3046,0.000186,3,0,3,18.496400996337503,#6e6e6e
3073,0.000094,0,3,3,12,#737373
3053,0.000114,1,0,1,13.596361604606898,#727272
3059,0.000137,2,0,2,15.283163521922663,#717171
3159,0.000137,2,1,3,15.283163521922663,#717171
3065,0.000254,3,0,3,22.37687632753905,#6b6b6b
3202,0.000094,0,3,3,12,#737373
3070,0.00016,2,1,3,16.846537660321623,#6f6f6f
3069,0.000309,3,0,3,25.18152108960815,#696969
3072,0.000239,3,0,3,21.56564352455313,#6c6c6c
3166,0.000094,0,1,1,12,#737373
3074,0.00023,3,0,3,21.067879224360784,#6c6c6c
3127,0.000137,2,1,3,15.283163521922663,#717171
3092,0.00023,2,0,2,21.067879224360784,#6c6c6c
3144,0.000133,1,1,2,14.999536055771733,#717171
3246,0.000094,0,2,2,12,#737373
3249,0.000094,0,1,1,12,#737373
3139,0.000109,1,0,1,13.209951757949934,#727272
3160,0.00013,1,0,1,14.784288150134541,#717171
3162,0.000114,1,0,1,13.596361604606898,#727272
3194,0.000094,0,1,1,12,#737373
3182,0.00012,1,0,1,14.050122216323361,#717171
3183,0.000131,1,0,1,14.856283440227312,#717171
3184,0.00012,1,0,1,14.050122216323361,#717171
3185,0.000111,1,0,1,13.365453519669122,#727272
3282,0.000094,0,1,1,12,#737373
3285,0.000113,1,0,1,13.5196994710513,#727272
3290,0.000094,0,1,1,12,#737373
3291,0.000094,0,1,1,12,#737373
3411,0.000497,3,4,7,33.37977449513971,#646464
3293,0.000403,3,0,3,29.498023818295955,#666666
3488,0.000193,1,1,2,18.92250746755846,#6e6e6e
3593,0.000094,0,2,2,12,#737373
3295,0.000196,2,1,3,19.102991324867094,#6e6e6e
3294,0.000652,4,0,4,39.11888525580386,#606060
3334,0.000247,2,1,3,22.0010632357656,#6c6c6c
3388,0.000094,0,1,1,12,#737373
3552,0.00012,1,1,2,14.050122216323361,#717171
3314,0.000133,1,3,4,14.999536055771733,#717171
4861,0.000153,1,2,3,16.382109723928565,#707070
3297,0.000655,3,1,4,39.22349908768588,#606060
3296,0.001172,5,0,5,54.86932436262595,#555555
3325,0.000241,1,1,2,21.675105650777578,#6c6c6c
3433,0.000133,1,1,2,14.999536055771733,#717171
3506,0.000133,1,2,3,14.999536055771733,#717171
3568,0.000173,2,1,3,17.685431661066666,#6f6f6f
3310,0.000509,6,2,8,33.8505463560455,#636363
3326,0.000376,1,1,2,28.30946605998667,#676767
3333,0.000119,1,4,5,13.975216770645698,#727272
3299,0.000798,5,1,6,43.98306377565895,#5d5d5d
3298,0.000828,2,0,2,44.93131783707848,#5c5c5c
3538,0.000133,1,2,3,14.999536055771733,#717171
3329,0.00055,8,1,9,35.42251228041583,#626262
3440,0.000094,0,1,1,12,#737373
3441,0.000094,0,1,1,12,#737373
3558,0.000094,0,2,2,12,#737373
3446,0.000113,1,2,3,13.5196994710513,#727272
3300,0.000142,1,0,1,15.632508821476176,#707070
3301,0.000208,3,0,3,19.812802667928878,#6d6d6d
3622,0.000094,0,2,2,12,#737373
3708,0.000094,0,3,3,12,#737373
3450,0.000094,0,1,1,12,#737373
3302,0.000257,3,0,3,22.536510218163954,#6b6b6b
3631,0.000105,1,2,3,12.895045046072177,#727272
3672,0.000094,0,2,2,12,#737373
3468,0.000689,8,6,14,40.39440257548451,#5f5f5f
3303,0.000191,1,0,1,18.801482814356014,#6e6e6e
3304,0.000191,1,0,1,18.801482814356014,#6e6e6e
3305,0.000191,1,0,1,18.801482814356014,#6e6e6e
3467,0.000424,5,1,6,30.397860923198664,#666666
3306,0.000454,1,0,1,31.649259069339983,#656565
3344,0.000213,3,1,4,20.103098863481684,#6d6d6d
3307,0.000762,7,0,7,42.82371739856607,#5d5d5d
3420,0.000269,1,1,2,23.166819740335022,#6b6b6b
3469,0.000094,0,2,2,12,#737373
3470,0.000094,0,2,2,12,#737373
3540,0.000133,1,1,2,14.999536055771733,#717171
3627,0.000094,0,3,3,12,#737373
3652,0.000094,0,2,2,12,#737373
3474,0.000094,0,1,1,12,#737373
3308,0.000428,5,0,5,30.566965295087698,#666666
3580,0.000094,0,3,3,12,#737373
3596,0.000207,1,1,2,19.754368044230688,#6d6d6d
3654,0.000094,0,3,3,12,#737373
3692,0.000094,0,3,3,12,#737373
3309,0.000421,4,0,4,30.270561055601863,#666666
3464,0.000094,0,2,2,12,#737373
3465,0.000094,0,3,3,12,#737373
3645,0.000105,1,2,3,12.895045046072177,#727272
3357,0.000094,0,2,2,12,#737373
3460,0.000094,0,1,1,12,#737373
3477,0.000094,0,1,1,12,#737373
3478,0.000094,0,1,1,12,#737373
3484,0.000263,2,2,4,22.85328285153254,#6b6b6b
3312,0.000994,9,1,10,49.920693307221654,#595959
3311,0.001066,2,0,2,51.96686272780954,#575757
3455,0.00015,1,1,2,16.180148347028588,#707070
3321,0.00036,4,1,5,27.586964296887757,#686868
3336,0.000311,2,3,5,25.27907526175206,#696969
3351,0.000445,7,2,9,31.277854705039218,#656565
3359,0.000173,2,2,4,17.685431661066666,#6f6f6f
3632,0.000094,0,2,2,12,#737373
3697,0.000094,0,3,3,12,#737373
3313,0.000171,2,0,2,17.5582653966192,#6f6f6f
3693,0.000094,0,2,2,12,#737373
3435,0.000094,0,2,2,12,#737373
3355,0.000636,8,2,10,38.55724690698436,#606060
3315,0.00045,4,0,4,31.48460337932012,#656565
3610,0.000094,0,2,2,12,#737373
3625,0.000094,0,3,3,12,#737373
3656,0.000094,0,4,4,12,#737373
3317,0.000973,6,1,7,49.311430962970356,#595959
3316,0.00125,6,0,6,56.93022410010779,#545454
3366,0.000094,0,1,1,12,#737373
3483,0.000133,1,1,2,14.999536055771733,#717171
3536,0.000133,1,2,3,14.999536055771733,#717171
3557,0.000094,0,2,2,12,#737373
3620,0.000094,0,2,2,12,#737373
3352,0.000564,6,1,7,35.94711287743362,#626262
3392,0.000094,0,1,1,12,#737373
3393,0.000094,0,1,1,12,#737373
3421,0.000133,1,1,2,14.999536055771733,#717171
3724,0.000094,0,2,2,12,#737373
3473,0.00026,1,1,2,22.69530774034737,#6b6b6b
3318,0.000466,2,0,2,32.13934967801786,#656565
4864,0.000179,2,1,3,18.06301462969796,#6f6f6f
3418,0.000185,2,1,3,18.434943664037807,#6e6e6e
3319,0.000482,5,0,5,32.78405507641063,#646464
3497,0.000264,5,2,7,22.905760819989744,#6b6b6b
3573,0.000094,0,2,2,12,#737373
3574,0.000094,0,2,2,12,#737373
3677,0.000094,0,2,2,12,#737373
3360,0.000292,3,2,5,24.340542711983574,#6a6a6a
3320,0.000722,5,0,5,41.50624756578634,#5e5e5e
3542,0.000207,2,1,3,19.754368044230688,#6d6d6d
3546,0.000094,0,1,1,12,#737373
3547,0.000094,0,1,1,12,#737373
3607,0.0002,2,1,3,19.341713958828393,#6e6e6e
3328,0.000173,2,2,4,17.685431661066666,#6f6f6f
3471,0.000133,1,1,2,14.999536055771733,#717171
3698,0.000094,0,2,2,12,#737373
3323,0.000566,2,1,3,36.02157518058237,#626262
3322,0.00091,4,0,4,47.44718841243124,#5a5a5a
3454,0.000133,1,2,3,14.999536055771733,#717171
3668,0.000133,1,1,2,14.999536055771733,#717171
4830,0.000195,2,1,3,19.04296905860749,#6e6e6e
3331,0.000301,4,2,6,24.78843171388773,#6a6a6a
3345,0.000405,3,1,4,29.58461761737899,#666666
3342,0.000232,2,3,5,21.179240350145598,#6c6c6c
3324,0.000188,2,0,2,18.618871286344486,#6e6e6e
3564,0.000133,1,4,5,14.999536055771733,#717171
3572,0.000173,2,1,3,17.685431661066666,#6f6f6f
3576,0.000332,4,1,5,26.28685674490043,#696969
3327,0.000233,3,0,3,21.234758886801874,#6c6c6c
3713,0.000094,0,2,2,12,#737373
3740,0.000094,0,3,3,12,#737373
3561,0.000094,0,2,2,12,#737373
3742,0.000094,0,2,2,12,#737373
3365,0.000133,1,2,3,14.999536055771733,#717171
3466,0.000094,0,2,2,12,#737373
3472,0.000094,0,2,2,12,#737373
3498,0.000233,2,2,4,21.234758886801874,#6c6c6c
3582,0.00012,1,1,2,14.050122216323361,#717171
3330,0.000376,4,0,4,28.30946605998667,#676767
3581,0.00012,1,1,2,14.050122216323361,#717171
3705,0.000094,0,3,3,12,#737373
4603,0.000094,0,1,1,12,#737373
4831,0.000145,1,2,3,15.839461562490118,#707070
3332,0.00017,3,0,3,17.494431323525504,#6f6f6f
3616,0.000094,0,2,2,12,#737373
3722,0.000094,0,7,7,12,#737373
4876,0.00012,1,4,5,14.050122216323361,#717171
3629,0.000133,1,1,2,14.999536055771733,#717171
4759,0.000094,0,2,2,12,#737373
3335,0.000182,1,0,1,18.249668885536508,#6e6e6e
4655,0.000133,1,4,5,14.999536055771733,#717171
3349,0.00012,1,2,3,14.050122216323361,#717171
3337,0.000409,5,0,5,29.757229929753784,#666666
3429,0.000196,1,2,3,19.102991324867094,#6e6e6e
3628,0.000094,0,2,2,12,#737373
4865,0.00012,1,1,2,14.050122216323361,#717171
3634,0.000249,1,1,2,22.108922047173674,#6c6c6c
3338,0.000305,1,0,1,24.98555638836362,#6a6a6a
3643,0.000126,1,1,2,14.493782114686502,#717171
3339,0.0002,1,0,1,19.341713958828393,#6e6e6e
3340,0.000159,1,0,1,16.78075881014393,#6f6f6f
3341,0.00025,3,0,3,22.162705238099072,#6c6c6c
3529,0.000094,0,2,2,12,#737373
4875,0.000119,1,2,3,13.975216770645698,#727272
3413,0.000133,1,1,2,14.999536055771733,#717171
3343,0.00048,8,0,8,32.70399923280961,#646464
3638,0.000094,0,2,2,12,#737373
3639,0.000113,1,1,2,13.5196994710513,#727272
3647,0.000094,0,2,2,12,#737373
3648,0.000094,0,2,2,12,#737373
3659,0.000094,0,2,2,12,#737373
3403,0.000247,2,1,3,22.0010632357656,#6c6c6c
4888,0.000147,2,2,4,15.97636096389552,#707070
3346,0.000244,2,0,2,21.838535319500465,#6c6c6c
3709,0.000094,0,3,3,12,#737373
3348,0.00012,1,1,2,14.050122216323361,#717171
3347,0.000456,6,0,6,31.73134206884572,#656565
3402,0.000094,0,2,2,12,#737373
3661,0.000213,2,2,4,20.103098863481684,#6d6d6d
3678,0.000094,0,2,2,12,#737373
3729,0.000094,0,2,2,12,#737373
4883,0.000094,0,3,3,12,#737373
3663,0.000094,0,3,3,12,#737373
3673,0.000094,0,2,2,12,#737373
3350,0.000332,5,0,5,26.28685674490043,#696969
3674,0.000094,0,2,2,12,#737373
3688,0.000094,0,1,1,12,#737373
3700,0.000094,0,2,2,12,#737373
3701,0.000094,0,2,2,12,#737373
3598,0.000094,0,2,2,12,#737373
3671,0.000094,0,2,2,12,#737373
3689,0.000133,1,1,2,14.999536055771733,#717171
3702,0.000094,0,2,2,12,#737373
3361,0.00012,1,2,3,14.050122216323361,#717171
3362,0.000317,1,1,2,25.570056738071315,#696969
3612,0.000094,0,3,3,12,#737373
4582,0.000094,0,3,3,12,#737373
3423,0.000278,2,1,3,23.63128434186593,#6b6b6b
3353,0.000606,4,0,4,37.48674925452058,#616161
3486,0.000435,3,2,5,30.861195944480013,#656565
3563,0.000122,1,2,3,14.199095341257646,#717171
3655,0.000094,0,2,2,12,#737373
3354,0.000364,1,0,1,27.76892210605493,#686868
3432,0.00012,1,2,3,14.050122216323361,#717171
3437,0.000133,1,1,2,14.999536055771733,#717171
3569,0.000133,1,1,2,14.999536055771733,#717171
3601,0.000094,0,3,3,12,#737373
3714,0.000094,0,1,1,12,#737373
3715,0.000094,0,1,1,12,#737373
3716,0.000094,0,2,2,12,#737373
3356,0.000351,5,0,5,27.17420166010308,#686868
3590,0.000173,1,2,3,17.685431661066666,#6f6f6f
3683,0.000218,2,2,4,20.390344347943245,#6d6d6d
3723,0.000094,0,2,2,12,#737373
3358,0.000333,5,0,5,26.334119821353525,#696969
3395,0.000094,0,1,1,12,#737373
3725,0.000094,0,2,2,12,#737373
3726,0.000094,0,4,4,12,#737373
3727,0.000094,0,3,3,12,#737373
3730,0.000094,0,1,1,12,#737373
4677,0.00016,2,2,4,16.846537660321623,#6f6f6f
4678,0.000094,0,3,3,12,#737373
4476,0.000527,4,2,6,34.547439986391424,#636363
3475,0.000094,0,1,1,12,#737373
3363,0.000224,2,0,2,20.731153739353275,#6d6d6d
4509,0.00012,1,2,3,14.050122216323361,#717171
3579,0.000094,0,2,2,12,#737373
3364,0.000471,2,0,2,32.34187538376585,#646464
4570,0.000397,4,1,5,29.237075180617616,#676767
3368,0.000392,2,1,3,29.01825928350827,#676767
3367,0.000427,1,0,1,30.52475611326538,#666666
3369,0.000144,1,1,2,15.770693283269225,#707070
3370,0.000207,1,1,2,19.754368044230688,#6d6d6d
3523,0.000133,1,1,2,14.999536055771733,#717171
3516,0.000094,0,1,1,12,#737373
3371,0.000296,4,0,4,24.540360432916078,#6a6a6a
3567,0.000094,0,3,3,12,#737373
3608,0.000094,0,2,2,12,#737373
3621,0.000133,1,2,3,14.999536055771733,#717171
4878,0.00033,5,4,9,26.19213799612306,#696969
3372,0.000164,1,0,1,17.10782210585562,#6f6f6f
3431,0.00016,2,5,7,16.846537660321623,#6f6f6f
3373,0.000121,1,0,1,14.124747288633095,#717171
3374,0.000121,1,0,1,14.124747288633095,#717171
3375,0.000121,1,0,1,14.124747288633095,#717171
3376,0.000145,1,0,1,15.839461562490118,#707070
3480,0.000213,2,1,3,20.103098863481684,#6d6d6d
3377,0.000274,1,0,1,23.425704036241918,#6b6b6b
3379,0.000094,0,1,1,12,#737373
3378,0.000505,3,0,3,33.6941828976396,#646464
3380,0.000094,0,1,1,12,#737373
4478,0.000297,2,1,3,24.590124646255656,#6a6a6a
4850,0.000247,3,2,5,22.0010632357656,#6c6c6c
3381,0.000198,1,0,1,19.222623922752323,#6e6e6e
3382,0.00012,1,0,1,14.050122216323361,#717171
3562,0.000173,1,2,3,17.685431661066666,#6f6f6f
3383,0.000167,1,0,1,17.301908082944657,#6f6f6f
3591,0.000133,1,2,3,14.999536055771733,#717171
3384,0.00015,1,0,1,16.180148347028588,#707070
3385,0.000198,1,0,1,19.222623922752323,#6e6e6e
3445,0.000272,3,1,4,23.32240754705169,#6b6b6b
3386,0.000325,1,0,1,25.954204386893895,#696969
3387,0.000164,1,0,1,17.10782210585562,#6f6f6f
3389,0.00012,1,0,1,14.050122216323361,#717171
3690,0.000196,1,1,2,19.102991324867094,#6e6e6e
3390,0.00026,1,0,1,22.69530774034737,#6b6b6b
3694,0.00012,1,1,2,14.050122216323361,#717171
3391,0.000196,1,0,1,19.102991324867094,#6e6e6e
3394,0.00012,1,0,1,14.050122216323361,#717171
3396,0.000113,1,0,1,13.5196994710513,#727272
3397,0.000113,1,0,1,13.5196994710513,#727272
3398,0.00012,1,0,1,14.050122216323361,#717171
3565,0.000122,1,2,3,14.199095341257646,#717171
3399,0.000174,2,0,2,17.748766657369394,#6f6f6f
3675,0.000133,1,4,5,14.999536055771733,#717171
3401,0.000296,3,1,4,24.540360432916078,#6a6a6a
3400,0.000503,3,0,3,33.6157921939326,#646464
3534,0.000094,0,1,1,12,#737373
3609,0.000184,1,2,3,18.373336658075203,#6e6e6e
3554,0.000145,1,1,2,15.839461562490118,#707070
3686,0.000094,0,2,2,12,#737373
3747,0.000133,1,1,2,14.999536055771733,#717171
3748,0.000094,0,2,2,12,#737373
3456,0.000279,3,1,4,23.682471018741992,#6b6b6b
3404,0.000371,2,0,2,28.085196944357673,#676767
3682,0.000094,0,2,2,12,#737373
3658,0.000133,1,1,2,14.999536055771733,#717171
3405,0.000207,1,0,1,19.754368044230688,#6d6d6d
3410,0.000318,4,2,6,25.61831187604224,#696969
3406,0.000229,1,0,1,21.012035273453705,#6c6c6c
3407,0.000229,1,0,1,21.012035273453705,#6c6c6c
3408,0.000199,1,0,1,19.282236265877913,#6e6e6e
3409,0.000199,1,0,1,19.282236265877913,#6e6e6e
3666,0.000094,0,2,2,12,#737373
3712,0.000094,0,2,2,12,#737373
3517,0.000335,2,1,3,26.42845477314982,#696969
3519,0.000094,0,1,1,12,#737373
3676,0.000094,0,2,2,12,#737373
3412,0.000231,2,0,2,21.123614021758055,#6c6c6c
3626,0.000094,0,2,2,12,#737373
3684,0.000094,0,2,2,12,#737373
3502,0.000094,0,2,2,12,#737373
3414,0.000173,2,0,2,17.685431661066666,#6f6f6f
3551,0.000094,0,2,2,12,#737373
3415,0.000231,2,0,2,21.123614021758055,#6c6c6c
3417,0.000121,1,1,2,14.124747288633095,#717171
3416,0.000303,3,0,3,24.887140432028936,#6a6a6a
3430,0.000094,0,1,1,12,#737373
3419,0.00012,1,0,1,14.050122216323361,#717171
3532,0.000207,1,1,2,19.754368044230688,#6d6d6d
3528,0.000094,0,1,1,12,#737373
3422,0.000225,2,0,2,20.787553985810852,#6d6d6d
3425,0.000094,0,1,1,12,#737373
3426,0.000247,2,2,4,22.0010632357656,#6c6c6c
3424,0.000198,1,0,1,19.222623922752323,#6e6e6e
3600,0.000133,1,1,2,14.999536055771733,#717171
3733,0.000094,0,2,2,12,#737373
3427,0.000173,2,0,2,17.685431661066666,#6f6f6f
3623,0.000094,0,2,2,12,#737373
3428,0.000177,1,0,1,17.937795520999256,#6f6f6f
3619,0.00012,1,1,2,14.050122216323361,#717171
3695,0.000094,0,3,3,12,#737373
3657,0.000094,0,2,2,12,#737373
3434,0.000162,2,0,2,16.977542788511858,#6f6f6f
3485,0.000305,2,2,4,24.98555638836362,#6a6a6a
3436,0.00025,2,0,2,22.162705238099072,#6c6c6c
3665,0.000094,0,2,2,12,#737373
3527,0.000094,0,2,2,12,#737373
3438,0.000173,2,0,2,17.685431661066666,#6f6f6f
3588,0.000094,0,2,2,12,#737373
3439,0.000167,1,0,1,17.301908082944657,#6f6f6f
3444,0.000094,0,1,1,12,#737373
3442,0.000213,2,0,2,20.103098863481684,#6d6d6d
3614,0.000094,0,2,2,12,#737373
3443,0.00012,1,0,1,14.050122216323361,#717171
3447,0.000094,0,1,1,12,#737373
3448,0.000094,0,1,1,12,#737373
3737,0.000094,0,4,4,12,#737373
3545,0.000388,2,2,4,28.842300770516935,#676767
3449,0.000298,2,0,2,24.63981351619035,#6a6a6a
3710,0.000094,0,2,2,12,#737373
3615,0.000094,0,2,2,12,#737373
3451,0.000133,1,0,1,14.999536055771733,#717171
3452,0.000206,1,0,1,19.695806249957098,#6d6d6d
3453,0.00023,2,0,2,21.067879224360784,#6c6c6c
3646,0.000094,0,1,1,12,#737373
4845,0.000094,0,2,2,12,#737373
3457,0.000094,0,1,1,12,#737373
3458,0.000094,0,1,1,12,#737373
3459,0.00012,1,0,1,14.050122216323361,#717171
3462,0.000233,2,1,3,21.234758886801874,#6c6c6c
3461,0.000292,1,0,1,24.340542711983574,#6a6a6a
3463,0.000133,1,1,2,14.999536055771733,#717171
3503,0.000133,1,1,2,14.999536055771733,#717171
3479,0.000094,0,1,1,12,#737373
3526,0.000133,1,1,2,14.999536055771733,#717171
3592,0.000133,1,1,2,14.999536055771733,#717171
3613,0.000133,1,1,2,14.999536055771733,#717171
3544,0.000196,1,1,2,19.102991324867094,#6e6e6e
3476,0.000133,1,0,1,14.999536055771733,#717171
3481,0.000094,0,1,1,12,#737373
3699,0.000094,0,2,2,12,#737373
3482,0.00015,1,0,1,16.180148347028588,#707070
3739,0.000094,0,2,2,12,#737373
3487,0.000308,1,1,2,25.13263746265548,#696969
3560,0.000094,0,2,2,12,#737373
3679,0.000253,2,1,3,22.323476700598142,#6b6b6b
3489,0.000278,2,0,2,23.63128434186593,#6b6b6b
3491,0.000148,2,1,3,16.044496277075513,#707070
3490,0.00022,1,0,1,20.50441114623677,#6d6d6d
3650,0.000145,1,1,2,15.839461562490118,#707070
3492,0.000216,1,0,1,20.275805650131435,#6d6d6d
3496,0.000094,0,1,1,12,#737373
3493,0.000226,3,0,3,20.843841544046825,#6d6d6d
3499,0.000094,0,3,3,12,#737373
3500,0.000094,0,3,3,12,#737373
3494,0.000226,3,0,3,20.843841544046825,#6d6d6d
3501,0.000094,0,3,3,12,#737373
3734,0.000094,0,1,1,12,#737373
3495,0.000226,3,0,3,20.843841544046825,#6d6d6d
3735,0.000094,0,1,1,12,#737373
3525,0.00012,1,2,3,14.050122216323361,#717171
3515,0.000133,1,1,2,14.999536055771733,#717171
3550,0.000094,0,2,2,12,#737373
3696,0.00012,1,1,2,14.050122216323361,#717171
3504,0.000235,2,0,2,21.345475258565315,#6c6c6c
3732,0.000094,0,2,2,12,#737373
3505,0.00015,1,0,1,16.180148347028588,#707070
3510,0.000162,1,1,2,16.977542788511858,#6f6f6f
3507,0.000231,1,0,1,21.123614021758055,#6c6c6c
3513,0.000094,0,2,2,12,#737373
3508,0.000133,1,0,1,14.999536055771733,#717171
3511,0.000294,4,1,5,24.440604495500473,#6a6a6a
3509,0.000343,1,0,1,26.803285186298606,#686868
3512,0.000162,2,2,4,16.977542788511858,#6f6f6f
3738,0.000094,0,2,2,12,#737373
3514,0.000253,4,0,4,22.323476700598142,#6b6b6b
3520,0.000094,0,1,1,12,#737373
3584,0.00019,1,1,2,18.740756670053315,#6e6e6e
3518,0.000133,1,0,1,14.999536055771733,#717171
3521,0.000133,1,0,1,14.999536055771733,#717171
3571,0.00012,1,1,2,14.050122216323361,#717171
3522,0.000235,2,0,2,21.345475258565315,#6c6c6c
3524,0.000145,1,0,1,15.839461562490118,#707070
3531,0.000094,0,1,1,12,#737373
3530,0.000213,2,0,2,20.103098863481684,#6d6d6d
3703,0.000094,0,2,2,12,#737373
3670,0.000133,1,1,2,14.999536055771733,#717171
3706,0.000196,1,2,3,19.102991324867094,#6e6e6e
3533,0.000177,1,0,1,17.937795520999256,#6f6f6f
3717,0.000094,0,2,2,12,#737373
3535,0.000133,1,0,1,14.999536055771733,#717171
3537,0.00023,2,0,2,21.067879224360784,#6c6c6c
3746,0.000094,0,1,1,12,#737373
3741,0.000094,0,2,2,12,#737373
3539,0.00012,1,0,1,14.050122216323361,#717171
3604,0.000207,1,1,2,19.754368044230688,#6d6d6d
3541,0.000462,3,0,3,31.976624070929397,#656565
3653,0.000094,0,1,1,12,#737373
3667,0.000133,1,1,2,14.999536055771733,#717171
4862,0.00035,2,1,3,27.12804667565457,#686868
3543,0.000391,1,0,1,28.97434569732119,#676767
3556,0.00012,1,1,2,14.050122216323361,#717171
3617,0.000094,0,1,1,12,#737373
3618,0.000253,1,1,2,22.323476700598142,#6b6b6b
3548,0.00012,1,0,1,14.050122216323361,#717171
3549,0.000177,1,0,1,17.937795520999256,#6f6f6f
3651,0.00012,1,2,3,14.050122216323361,#717171
3605,0.000173,1,2,3,17.685431661066666,#6f6f6f
3555,0.000245,2,0,2,21.892810694385922,#6c6c6c
3559,0.000133,1,0,1,14.999536055771733,#717171
3744,0.000094,0,1,1,12,#737373
3719,0.000094,0,3,3,12,#737373
3566,0.00012,1,0,1,14.050122216323361,#717171
3577,0.000094,0,2,2,12,#737373
3731,0.000094,0,2,2,12,#737373
3570,0.00012,1,0,1,14.050122216323361,#717171
3589,0.000094,0,2,2,12,#737373
3575,0.000133,1,0,1,14.999536055771733,#717171
3578,0.000094,0,1,1,12,#737373
3718,0.000094,0,1,1,12,#737373
3585,0.000113,1,1,2,13.5196994710513,#727272
3624,0.000094,0,1,1,12,#737373
3662,0.000094,0,2,2,12,#737373
3594,0.000113,1,0,1,13.5196994710513,#727272
3595,0.00012,1,0,1,14.050122216323361,#717171
3597,0.000133,1,1,2,14.999536055771733,#717171
3599,0.00016,2,0,2,16.846537660321623,#6f6f6f
3602,0.00012,1,0,1,14.050122216323361,#717171
3603,0.000247,2,0,2,22.0010632357656,#6c6c6c
3660,0.000094,0,1,1,12,#737373
3611,0.000133,1,1,2,14.999536055771733,#717171
3606,0.000094,0,1,1,12,#737373
3736,0.000094,0,1,1,12,#737373
3669,0.000094,0,2,2,12,#737373
3649,0.000187,2,1,3,18.557709820386023,#6e6e6e
3630,0.000138,1,0,1,15.353485735564822,#717171
3633,0.000198,2,0,2,19.222623922752323,#6e6e6e
3635,0.000183,1,1,2,18.311578797501046,#6e6e6e
3721,0.000105,1,1,2,12.895045046072177,#727272
3636,0.00012,1,0,1,14.050122216323361,#717171
3641,0.000133,1,1,2,14.999536055771733,#717171
3640,0.000207,1,0,1,19.754368044230688,#6d6d6d
4885,0.000255,1,4,5,22.430181432297555,#6b6b6b
3642,0.000148,1,0,1,16.044496277075513,#707070
4628,0.000113,1,3,4,13.5196994710513,#727272
3644,0.000138,1,0,1,15.353485735564822,#717171
3743,0.000094,0,1,1,12,#737373
3664,0.000113,1,0,1,13.5196994710513,#727272
3745,0.000094,0,2,2,12,#737373
3680,0.000094,0,1,1,12,#737373
3681,0.000094,0,1,1,12,#737373
3685,0.000133,1,1,2,14.999536055771733,#717171
3728,0.000133,1,1,2,14.999536055771733,#717171
3687,0.000207,1,0,1,19.754368044230688,#6d6d6d
3691,0.00012,1,1,2,14.050122216323361,#717171
3704,0.00012,1,0,1,14.050122216323361,#717171
3707,0.00012,1,1,2,14.050122216323361,#717171
3711,0.000173,2,0,2,17.685431661066666,#6f6f6f
3720,0.000113,1,0,1,13.5196994710513,#727272
3778,0.00012,1,2,3,14.050122216323361,#717171
3749,0.000184,2,0,2,18.373336658075203,#6e6e6e
3932,0.000094,0,2,2,12,#737373
3762,0.000398,5,2,7,29.28068923771282,#676767
3750,0.000569,3,0,3,36.13304699442957,#626262
3767,0.000187,1,1,2,18.557709820386023,#6e6e6e
3793,0.000347,2,2,4,26.989224450772824,#686868
3751,0.00041,2,0,2,29.80026414973662,#666666
3773,0.000277,1,1,2,23.580014741542964,#6b6b6b
3752,0.000426,3,0,3,30.48250242520127,#666666
3804,0.000133,1,2,3,14.999536055771733,#717171
3936,0.000094,0,2,2,12,#737373
3754,0.000161,1,1,2,16.912131765928624,#6f6f6f
3753,0.000487,3,0,3,32.98354326329411,#646464
3755,0.000145,1,1,2,15.839461562490118,#707070
3774,0.000157,2,1,3,16.648640101132177,#707070
3784,0.000238,2,3,5,21.510757906638762,#6c6c6c
3757,0.000311,3,1,4,25.27907526175206,#696969
3756,0.000358,1,0,1,27.495644279994334,#686868
3792,0.00057,2,4,6,36.17014546293693,#626262
3930,0.000133,1,2,3,14.999536055771733,#717171
3931,0.000094,0,2,2,12,#737373
3759,0.000094,0,1,1,12,#737373
3758,0.00046,3,0,3,31.895023551293622,#656565
3883,0.000196,1,1,2,19.102991324867094,#6e6e6e
3761,0.000227,2,1,3,20.900017136346257,#6c6c6c
3760,0.000286,1,0,1,24.03849160370686,#6a6a6a
3788,0.000155,2,2,4,16.515761823530525,#707070
3764,0.000094,0,1,1,12,#737373
3926,0.000094,0,1,1,12,#737373
3935,0.000094,0,2,2,12,#737373
3765,0.000094,0,1,1,12,#737373
3763,0.000557,5,0,5,35.68555429381049,#626262
3766,0.000263,3,1,4,22.85328285153254,#6b6b6b
3789,0.000115,1,2,3,13.672721716220668,#727272
3946,0.000094,0,1,1,12,#737373
4199,0.000227,3,6,9,20.900017136346257,#6c6c6c
3801,0.000116,1,2,3,13.748783606650441,#727272
3838,0.000548,5,5,10,35.34708113191448,#626262
3938,0.000094,0,3,3,12,#737373
3768,0.000213,2,0,2,20.103098863481684,#6d6d6d
3943,0.000094,0,3,3,12,#737373
3782,0.00012,1,1,2,14.050122216323361,#717171
3772,0.000094,0,1,1,12,#737373
3771,0.000798,4,0,4,43.98306377565895,#5d5d5d
3783,0.0006,7,1,8,37.26981019560704,#616161
3825,0.000119,1,2,3,13.975216770645698,#727272
3847,0.00015,1,2,3,16.180148347028588,#707070
3795,0.000433,1,2,3,30.777348855163215,#666666
3797,0.000213,2,5,7,20.103098863481684,#6d6d6d
3863,0.00016,2,5,7,16.846537660321623,#6f6f6f
3776,0.00013,1,1,2,14.784288150134541,#717171
3775,0.000764,6,0,6,42.88876363263354,#5d5d5d
3777,0.00013,1,1,2,14.784288150134541,#717171
3809,0.000309,4,1,5,25.18152108960815,#696969
3921,0.000094,0,2,2,12,#737373
3922,0.000094,0,3,3,12,#737373
3779,0.000757,6,0,6,42.66076485691046,#5d5d5d
3816,0.000289,1,1,2,24.189869906310776,#6a6a6a
3851,0.000121,1,2,3,14.124747288633095,#717171
3855,0.000133,1,2,3,14.999536055771733,#717171
3871,0.000159,2,1,3,16.78075881014393,#6f6f6f
3893,0.000133,1,2,3,14.999536055771733,#717171
3780,0.000325,2,0,2,25.954204386893895,#696969
3790,0.000133,1,1,2,14.999536055771733,#717171
3785,0.000381,4,3,7,28.532397098919894,#676767
3798,0.000332,3,2,5,26.28685674490043,#696969
3870,0.000094,0,3,3,12,#737373
3836,0.000156,2,1,3,16.582296788749808,#707070
3841,0.000094,0,1,1,12,#737373
3842,0.000094,0,2,2,12,#737373
3868,0.000094,0,2,2,12,#737373
3879,0.000094,0,2,2,12,#737373
3787,0.000142,1,2,3,15.632508821476176,#707070
3905,0.000126,1,2,3,14.493782114686502,#717171
3786,0.000436,5,0,5,30.903054430226412,#656565
3857,0.000094,0,2,2,12,#737373
3886,0.000094,0,1,1,12,#737373
3891,0.000144,1,1,2,15.770693283269225,#707070
3896,0.000094,0,2,2,12,#737373
3895,0.000226,4,9,13,20.843841544046825,#6d6d6d
3937,0.000094,0,2,2,12,#737373
3791,0.000215,1,0,1,20.218357360452792,#6d6d6d
3822,0.00053,2,1,3,34.66254109638638,#636363
3794,0.000277,1,1,2,23.580014741542964,#6b6b6b
3904,0.000147,1,7,8,15.97636096389552,#707070
3802,0.000399,5,1,6,29.32425401023552,#676767
3796,0.000791,8,0,8,43.75950855117366,#5d5d5d
3799,0.000094,0,1,1,12,#737373
3854,0.00015,1,1,2,16.180148347028588,#707070
3876,0.000144,1,1,2,15.770693283269225,#707070
3877,0.000119,1,2,3,13.975216770645698,#727272
3887,0.000207,2,1,3,19.754368044230688,#6d6d6d
3916,0.00012,1,4,5,14.050122216323361,#717171
3934,0.000094,0,1,1,12,#737373
3800,0.000094,0,1,1,12,#737373
3939,0.000094,0,1,1,12,#737373
3940,0.000094,0,1,1,12,#737373
3941,0.000094,0,1,1,12,#737373
3918,0.000133,1,5,6,14.999536055771733,#717171
3803,0.000152,2,1,3,16.314988912055327,#707070
3928,0.000094,0,2,2,12,#737373
3944,0.000094,0,2,2,12,#737373
3805,0.000147,2,0,2,15.97636096389552,#707070
3864,0.000094,0,3,3,12,#737373
3807,0.000171,2,1,3,17.5582653966192,#6f6f6f
3806,0.000332,2,0,2,26.28685674490043,#696969
3844,0.000094,0,3,3,12,#737373
3901,0.00012,1,2,3,14.050122216323361,#717171
3875,0.00029,2,1,3,24.24017204011931,#6a6a6a
3808,0.000435,2,0,2,30.861195944480013,#656565
3894,0.000111,1,1,2,13.365453519669122,#727272
3945,0.000094,0,1,1,12,#737373
3811,0.000177,2,1,3,17.937795520999256,#6f6f6f
3810,0.000283,2,0,2,23.88639704795272,#6a6a6a
3821,0.000094,0,2,2,12,#737373
3831,0.000133,1,2,3,14.999536055771733,#717171
3813,0.000187,1,1,2,18.557709820386023,#6e6e6e
3812,0.000353,3,0,3,27.266334466722924,#686868
3843,0.00012,1,2,3,14.050122216323361,#717171
3898,0.000116,1,2,3,13.748783606650441,#727272
3814,0.000201,2,0,2,19.40105797672826,#6e6e6e
3908,0.00012,1,2,3,14.050122216323361,#717171
3819,0.000094,0,1,1,12,#737373
3815,0.000253,3,0,3,22.323476700598142,#6b6b6b
3849,0.000094,0,2,2,12,#737373
3817,0.00023,2,1,3,21.067879224360784,#6c6c6c
3889,0.000094,0,1,1,12,#737373
3890,0.000133,1,2,3,14.999536055771733,#717171
3880,0.00012,1,1,2,14.050122216323361,#717171
3818,0.000196,1,0,1,19.102991324867094,#6e6e6e
3820,0.000133,1,0,1,14.999536055771733,#717171
3823,0.000292,3,1,4,24.340542711983574,#6a6a6a
3881,0.000221,2,1,3,20.56126952844315,#6d6d6d
3912,0.000094,0,2,2,12,#737373
3913,0.00012,1,1,2,14.050122216323361,#717171
3824,0.000184,2,0,2,18.373336658075203,#6e6e6e
3903,0.00012,1,4,5,14.050122216323361,#717171
3826,0.000194,3,0,3,18.982808118734695,#6e6e6e
3828,0.000094,0,1,1,12,#737373
3827,0.000253,3,0,3,22.323476700598142,#6b6b6b
3856,0.000094,0,2,2,12,#737373
3830,0.000291,2,1,3,24.290396179232058,#6a6a6a
3829,0.000486,4,0,4,32.943719628852016,#646464
3837,0.000115,1,1,2,13.672721716220668,#727272
3900,0.000094,0,3,3,12,#737373
3832,0.000207,1,1,2,19.754368044230688,#6d6d6d
3833,0.000133,1,1,2,14.999536055771733,#717171
3919,0.000094,0,2,2,12,#737373
3835,0.000094,0,1,1,12,#737373
3834,0.00042,5,0,5,30.228037116296132,#666666
3850,0.000145,1,1,2,15.839461562490118,#707070
3907,0.000094,0,2,2,12,#737373
3839,0.000167,1,1,2,17.301908082944657,#6f6f6f
3840,0.000145,1,1,2,15.839461562490118,#707070
3862,0.000145,1,1,2,15.839461562490118,#707070
3906,0.000094,0,2,2,12,#737373
3923,0.000173,1,2,3,17.685431661066666,#6f6f6f
3872,0.000214,2,2,4,20.160788703714612,#6d6d6d
3845,0.000433,2,0,2,30.777348855163215,#666666
3873,0.000292,2,1,3,24.340542711983574,#6a6a6a
3846,0.000157,1,0,1,16.648640101132177,#707070
3859,0.000133,1,2,3,14.999536055771733,#717171
3848,0.000181,3,0,3,18.18760570927212,#6e6e6e
3920,0.000094,0,2,2,12,#737373
3927,0.000094,0,3,3,12,#737373
3853,0.000247,2,1,3,22.0010632357656,#6c6c6c
3852,0.000303,1,0,1,24.887140432028936,#6a6a6a
3861,0.000133,1,1,2,14.999536055771733,#717171
3888,0.000133,1,2,3,14.999536055771733,#717171
3858,0.00015,1,0,1,16.180148347028588,#707070
3902,0.000119,1,2,3,13.975216770645698,#727272
3860,0.00017,2,0,2,17.494431323525504,#6f6f6f
3914,0.000094,0,2,2,12,#737373
3866,0.000151,2,1,3,16.24766909105304,#707070
3865,0.00024,2,0,2,21.620425898203866,#6c6c6c
3867,0.000206,2,0,2,19.695806249957098,#6d6d6d
3869,0.00012,1,0,1,14.050122216323361,#717171
3915,0.000094,0,2,2,12,#737373
3911,0.000116,1,1,2,13.748783606650441,#727272
3874,0.00014,2,1,3,15.493445725621832,#707070
3929,0.000094,0,1,1,12,#737373
3878,0.000111,1,1,2,13.365453519669122,#727272
3892,0.00012,1,1,2,14.050122216323361,#717171
3925,0.000094,0,3,3,12,#737373
3882,0.00012,1,1,2,14.050122216323361,#717171
3917,0.000094,0,3,3,12,#737373
3910,0.00012,1,1,2,14.050122216323361,#717171
3885,0.000151,2,1,3,16.24766909105304,#707070
3884,0.00024,2,0,2,21.620425898203866,#6c6c6c
3909,0.000094,0,2,2,12,#737373
3897,0.000256,3,0,3,22.483392551881522,#6b6b6b
3933,0.000094,0,2,2,12,#737373
3899,0.00012,1,0,1,14.050122216323361,#717171
3924,0.000094,0,1,1,12,#737373
3942,0.00012,1,0,1,14.050122216323361,#717171
3973,0.000322,2,1,3,25.81065314144071,#696969
3947,0.000367,1,0,1,27.9048006397121,#686868
3956,0.000522,2,1,3,34.35494752377393,#636363
3948,0.000715,3,0,3,41.27234486524085,#5e5e5e
3978,0.000133,1,1,2,14.999536055771733,#717171
4012,0.000153,1,2,3,16.382109723928565,#707070
3950,0.000181,1,1,2,18.18760570927212,#6e6e6e
3949,0.000424,2,0,2,30.397860923198664,#666666
3998,0.000207,1,1,2,19.754368044230688,#6d6d6d
3975,0.000207,1,2,3,19.754368044230688,#6d6d6d
3951,0.000221,2,0,2,20.56126952844315,#6d6d6d
3980,0.000094,0,2,2,12,#737373
4040,0.000203,2,1,3,19.51934882871322,#6d6d6d
3952,0.000266,1,0,1,23.01044912007304,#6b6b6b
3983,0.000269,1,2,3,23.166819740335022,#6b6b6b
3953,0.000384,2,0,2,28.665524040933125,#676767
4000,0.000414,3,2,5,29.97193062100049,#666666
3966,0.000356,4,1,5,27.4040943973584,#686868
3954,0.000539,4,0,4,35.00609707515816,#636363
3995,0.00015,1,2,3,16.180148347028588,#707070
4062,0.000094,0,2,2,12,#737373
4064,0.000094,0,2,2,12,#737373
3969,0.000289,1,3,4,24.189869906310776,#6a6a6a
3955,0.000255,3,0,3,22.430181432297555,#6b6b6b
4055,0.000094,0,2,2,12,#737373
4056,0.000094,0,2,2,12,#737373
3957,0.000371,5,1,6,28.085196944357673,#676767
3963,0.000133,1,1,2,14.999536055771733,#717171
3965,0.000216,1,2,3,20.275805650131435,#6d6d6d
3979,0.000233,3,5,8,21.234758886801874,#6c6c6c
3989,0.000094,0,1,1,12,#737373
4008,0.000094,0,2,2,12,#737373
4031,0.000094,0,3,3,12,#737373
3959,0.00036,4,1,5,27.586964296887757,#686868
3958,0.000479,3,0,3,32.663915025546146,#646464
3999,0.000094,0,2,2,12,#737373
4016,0.000094,0,2,2,12,#737373
3997,0.000094,0,2,2,12,#737373
4011,0.000173,1,1,2,17.685431661066666,#6f6f6f
3962,0.000266,2,2,4,23.01044912007304,#6b6b6b
3960,0.00029,3,0,3,24.24017204011931,#6a6a6a
4034,0.000207,1,4,5,19.754368044230688,#6d6d6d
3961,0.000263,2,0,2,22.85328285153254,#6b6b6b
4045,0.000133,1,2,3,14.999536055771733,#717171
4004,0.000167,1,1,2,17.301908082944657,#6f6f6f
4047,0.000109,1,3,4,13.209951757949934,#727272
3964,0.000185,1,0,1,18.434943664037807,#6e6e6e
4002,0.000144,2,1,3,15.770693283269225,#707070
3985,0.000235,2,2,4,21.345475258565315,#6c6c6c
4041,0.000292,3,3,6,24.340542711983574,#6a6a6a
4063,0.000094,0,2,2,12,#737373
3967,0.000175,1,0,1,17.811938066790663,#6f6f6f
3968,0.000175,1,0,1,17.811938066790663,#6f6f6f
3971,0.000459,2,2,4,31.85416342574387,#656565
3970,0.000708,2,0,2,41.037409390734396,#5f5f5f
3972,0.000493,2,1,3,33.22171647204136,#646464
4029,0.000215,3,4,7,20.218357360452792,#6d6d6d
4072,0.000376,1,1,2,28.30946605998667,#676767
3992,0.000317,3,1,4,25.570056738071315,#696969
4005,0.000153,1,1,2,16.382109723928565,#707070
3984,0.000194,1,1,2,18.982808118734695,#6e6e6e
4078,0.000094,0,3,3,12,#737373
3974,0.00012,1,0,1,14.050122216323361,#717171
3994,0.000133,1,1,2,14.999536055771733,#717171
3976,0.000133,1,0,1,14.999536055771733,#717171
3977,0.000133,1,0,1,14.999536055771733,#717171
4020,0.000094,0,4,4,12,#737373
4027,0.000094,0,1,1,12,#737373
3981,0.000231,2,0,2,21.123614021758055,#6c6c6c
4038,0.000109,1,4,5,13.209951757949934,#727272
4067,0.000133,1,1,2,14.999536055771733,#717171
3986,0.00012,1,1,2,14.050122216323361,#717171
4006,0.000229,1,1,2,21.012035273453705,#6c6c6c
3988,0.000391,2,0,2,28.97434569732119,#676767
4048,0.00012,1,1,2,14.050122216323361,#717171
3991,0.00021,1,1,2,19.929293935525752,#6d6d6d
3990,0.000312,2,0,2,25.32774646933066,#696969
4025,0.000094,0,2,2,12,#737373
4003,0.000137,1,1,2,15.283163521922663,#717171
4013,0.000094,0,1,1,12,#737373
4021,0.000094,0,1,1,12,#737373
4033,0.000137,1,3,4,15.283163521922663,#717171
3993,0.000133,1,0,1,14.999536055771733,#717171
4068,0.000094,0,2,2,12,#737373
4065,0.000133,1,2,3,14.999536055771733,#717171
3996,0.000173,2,0,2,17.685431661066666,#6f6f6f
4050,0.000133,1,1,2,14.999536055771733,#717171
4001,0.0003,1,1,2,24.738966688159792,#6a6a6a
4030,0.000243,3,1,4,21.78415975388338,#6c6c6c
4036,0.000172,3,2,5,17.621931704978525,#6f6f6f
4028,0.000139,1,2,3,15.423579008661793,#707070
4007,0.00016,2,1,3,16.846537660321623,#6f6f6f
4049,0.000094,0,3,3,12,#737373
4018,0.000143,1,1,2,15.701709764920519,#707070
4009,0.000398,4,0,4,29.28068923771282,#676767
4037,0.000117,1,2,3,13.824550996532153,#727272
4046,0.000094,0,2,2,12,#737373
4079,0.000109,1,1,2,13.209951757949934,#727272
4010,0.000198,2,0,2,19.222623922752323,#6e6e6e
4017,0.000094,0,1,1,12,#737373
4014,0.000163,2,0,2,17.042772364524353,#6f6f6f
4015,0.000212,3,0,3,20.045287013917818,#6d6d6d
4058,0.000094,0,2,2,12,#737373
4019,0.000113,1,0,1,13.5196994710513,#727272
4026,0.000133,1,1,2,14.999536055771733,#717171
4032,0.000094,0,1,1,12,#737373
4080,0.000094,0,5,5,12,#737373
4039,0.000094,0,2,2,12,#737373
4057,0.000133,1,1,2,14.999536055771733,#717171
4042,0.000094,0,1,1,12,#737373
4043,0.000094,0,1,1,12,#737373
4066,0.000094,0,2,2,12,#737373
4044,0.00015,1,0,1,16.180148347028588,#707070
4053,0.000094,0,2,2,12,#737373
4052,0.000437,2,1,3,30.944869735648133,#656565
4051,0.000504,2,0,2,33.65500504372394,#646464
4069,0.000202,1,1,2,19.460269282829312,#6e6e6e
4070,0.000202,1,1,2,19.460269282829312,#6e6e6e
4054,0.000133,1,0,1,14.999536055771733,#717171
4060,0.000269,3,1,4,23.166819740335022,#6b6b6b
4059,0.000436,2,0,2,30.903054430226412,#656565
4061,0.000133,1,1,2,14.999536055771733,#717171
4071,0.000094,0,1,1,12,#737373
4105,0.000382,1,3,4,28.57682498606312,#676767
4073,0.000332,3,1,4,26.28685674490043,#696969
4074,0.000094,0,1,1,12,#737373
4075,0.000094,0,1,1,12,#737373
4076,0.000094,0,1,1,12,#737373
4077,0.00012,1,0,1,14.050122216323361,#717171
4086,0.000318,2,3,5,25.61831187604224,#696969
4081,0.000184,1,0,1,18.373336658075203,#6e6e6e
4084,0.000603,3,2,5,37.37840114674177,#616161
4082,0.00035,1,0,1,27.12804667565457,#686868
4083,0.00035,1,0,1,27.12804667565457,#686868
4090,0.000448,3,2,5,31.402028585233786,#656565
4085,0.000184,1,0,1,18.373336658075203,#6e6e6e
4162,0.000159,2,4,6,16.78075881014393,#6f6f6f
4166,0.000919,4,1,5,47.716986648859425,#5a5a5a
4087,0.001052,4,0,4,51.57398714333227,#575757
4218,0.000335,2,5,7,26.42845477314982,#696969
4267,0.000094,0,1,1,12,#737373
4089,0.000377,2,1,3,28.354158489611223,#676767
4088,0.000628,2,0,2,38.274044254537664,#606060
4299,0.000253,2,1,3,22.323476700598142,#6b6b6b
4187,0.000691,5,3,8,40.462460096655036,#5f5f5f
4188,0.000308,1,3,4,25.13263746265548,#696969
4121,0.000284,3,2,5,23.937175492264057,#6a6a6a
4160,0.000244,3,1,4,21.838535319500465,#6c6c6c
4217,0.000094,0,3,3,12,#737373
4092,0.000336,3,1,4,26.475527200275646,#696969
4091,0.000379,1,0,1,28.443383609295267,#676767
4116,0.000094,0,1,1,12,#737373
4189,0.000145,1,1,2,15.839461562490118,#707070
4208,0.000094,0,2,2,12,#737373
4102,0.000496,3,1,4,33.34031382039815,#646464
4093,0.000555,2,0,2,35.61055198801202,#626262
4285,0.000094,0,2,2,12,#737373
4152,0.0004,2,3,5,29.367769677189468,#676767
4094,0.000287,2,0,2,24.089030084755148,#6a6a6a
4279,0.000376,1,4,5,28.30946605998667,#676767
4095,0.000202,1,0,1,19.460269282829312,#6e6e6e
4106,0.000679,4,2,6,40.052773047515174,#5f5f5f
4096,0.000382,1,0,1,28.57682498606312,#676767
4136,0.00012,1,1,2,14.050122216323361,#717171
4097,0.000596,5,0,5,37.124641454818956,#616161
4200,0.000094,0,1,1,12,#737373
4222,0.000094,0,3,3,12,#737373
4245,0.000094,0,1,1,12,#737373
4246,0.000253,2,1,3,22.323476700598142,#6b6b6b
4147,0.000536,3,2,5,34.8918672703797,#636363
4098,0.00056,4,0,4,35.79783090305132,#626262
4281,0.000094,0,1,1,12,#737373
4282,0.000094,0,1,1,12,#737373
4283,0.000094,0,1,1,12,#737373
4110,0.000476,4,1,5,32.54343589505605,#646464
4101,0.000189,3,1,4,18.67988652940294,#6e6e6e
4100,0.000493,4,0,4,33.22171647204136,#646464
4241,0.000094,0,1,1,12,#737373
4244,0.000094,0,1,1,12,#737373
4260,0.000094,0,1,1,12,#737373
4206,0.000158,2,3,5,16.714793528209434,#707070
4227,0.000094,0,2,2,12,#737373
4151,0.00088,4,3,7,46.53907042205552,#5b5b5b
4305,0.000173,1,2,3,17.685431661066666,#6f6f6f
4306,0.000094,0,1,1,12,#737373
4104,0.000094,0,1,1,12,#737373
4103,0.000366,3,0,3,27.85956352259946,#686868
4225,0.000094,0,1,1,12,#737373
4107,0.000241,1,1,2,21.675105650777578,#6c6c6c
4109,0.000094,0,2,2,12,#737373
4144,0.000133,1,1,2,14.999536055771733,#717171
4184,0.000173,1,1,2,17.685431661066666,#6f6f6f
4108,0.000133,1,0,1,14.999536055771733,#717171
4138,0.000666,3,3,6,39.60525108075884,#5f5f5f
4156,0.000157,1,4,5,16.648640101132177,#707070
4243,0.000094,0,2,2,12,#737373
4201,0.000121,1,2,3,14.124747288633095,#717171
4221,0.000131,2,4,6,14.856283440227312,#717171
4268,0.000094,0,1,1,12,#737373
4213,0.000094,0,2,2,12,#737373
4114,0.000416,3,1,4,30.05748391770498,#666666
4149,0.0002,2,1,3,19.341713958828393,#6e6e6e
4320,0.000094,0,1,1,12,#737373
4115,0.00035,3,0,3,27.12804667565457,#686868
4118,0.000214,3,1,4,20.160788703714612,#6d6d6d
4117,0.000434,3,0,3,30.81929413439979,#666666
4239,0.000094,0,1,1,12,#737373
4240,0.000094,0,1,1,12,#737373
4124,0.000094,0,3,3,12,#737373
4154,0.000191,3,3,6,18.801482814356014,#6e6e6e
4159,0.000094,0,2,2,12,#737373
4119,0.00031,4,0,4,25.230333578472866,#696969
4163,0.000217,2,2,4,20.333134379934826,#6d6d6d
4143,0.000094,0,4,4,12,#737373
4150,0.000143,1,1,2,15.701709764920519,#707070
4202,0.000173,1,3,4,17.685431661066666,#6f6f6f
4122,0.00012,1,0,1,14.050122216323361,#717171
4123,0.00012,1,0,1,14.050122216323361,#717171
4128,0.000341,4,3,7,26.70994970428908,#686868
4125,0.00019,1,0,1,18.740756670053315,#6e6e6e
4126,0.00019,1,0,1,18.740756670053315,#6e6e6e
4127,0.00027,2,0,2,23.218768698136756,#6b6b6b
4252,0.000094,0,1,1,12,#737373
4186,0.000184,2,1,3,18.373336658075203,#6e6e6e
4323,0.000094,0,1,1,12,#737373
4324,0.000094,0,1,1,12,#737373
4131,0.000109,1,1,2,13.209951757949934,#727272
4130,0.000187,1,0,1,18.557709820386023,#6e6e6e
4196,0.000094,0,5,5,12,#737373
4133,0.000113,1,1,2,13.5196994710513,#727272
4132,0.000223,2,0,2,20.67464007448106,#6d6d6d
4135,0.000094,0,1,1,12,#737373
4134,0.000673,3,0,3,39.84670802053496,#5f5f5f
4158,0.000366,4,1,5,27.85956352259946,#686868
4137,0.000791,4,0,4,43.75950855117366,#5d5d5d
4157,0.000412,4,1,5,29.886191135675617,#666666
4238,0.000094,0,1,1,12,#737373
4259,0.000094,0,1,1,12,#737373
4224,0.000571,6,1,7,36.207214654719394,#626262
4139,0.000557,2,0,2,35.68555429381049,#626262
4175,0.000253,2,1,3,22.323476700598142,#6b6b6b
4140,0.000113,1,0,1,13.5196994710513,#727272
4141,0.000113,1,0,1,13.5196994710513,#727272
4142,0.000113,1,0,1,13.5196994710513,#727272
4146,0.000094,0,2,2,12,#737373
4171,0.000201,1,2,3,19.40105797672826,#6e6e6e
4204,0.000253,2,2,4,22.323476700598142,#6b6b6b
4325,0.000094,0,1,1,12,#737373
4326,0.000094,0,1,1,12,#737373
4209,0.000491,5,1,6,33.14247108015606,#646464
4212,0.000167,1,1,2,17.301908082944657,#6f6f6f
4215,0.000133,1,1,2,14.999536055771733,#717171
4165,0.000253,2,1,3,22.323476700598142,#6b6b6b
4153,0.000227,2,0,2,20.900017136346257,#6c6c6c
4253,0.000094,0,1,1,12,#737373
4193,0.000173,1,6,7,17.685431661066666,#6f6f6f
4155,0.000366,4,0,4,27.85956352259946,#686868
4242,0.000094,0,1,1,12,#737373
4249,0.000094,0,1,1,12,#737373
4258,0.000094,0,1,1,12,#737373
4194,0.00015,1,2,3,16.180148347028588,#707070
4223,0.000094,0,1,1,12,#737373
4228,0.000094,0,1,1,12,#737373
4229,0.000094,0,1,1,12,#737373
4233,0.000094,0,1,1,12,#737373
4230,0.000094,0,1,1,12,#737373
4231,0.000094,0,1,1,12,#737373
4232,0.000094,0,1,1,12,#737373
4269,0.000094,0,1,1,12,#737373
4161,0.000207,2,0,2,19.754368044230688,#6d6d6d
4251,0.000094,0,1,1,12,#737373
4216,0.000094,0,2,2,12,#737373
4174,0.000143,2,1,3,15.701709764920519,#707070
4207,0.000133,1,3,4,14.999536055771733,#717171
4288,0.000094,0,1,1,12,#737373
4289,0.000094,0,1,1,12,#737373
4181,0.000761,5,1,6,42.791165472923105,#5d5d5d
4214,0.00012,1,2,3,14.050122216323361,#717171
4168,0.000094,0,1,1,12,#737373
4167,0.000268,3,0,3,23.114783806097357,#6b6b6b
4169,0.000094,0,1,1,12,#737373
4170,0.000179,1,0,1,18.06301462969796,#6f6f6f
4176,0.000094,0,1,1,12,#737373
4280,0.000094,0,1,1,12,#737373
4177,0.000109,1,0,1,13.209951757949934,#727272
4178,0.000109,1,0,1,13.209951757949934,#727272
4182,0.000253,2,1,3,22.323476700598142,#6b6b6b
4180,0.000599,4,0,4,37.233558942678656,#616161
4290,0.000094,0,1,1,12,#737373
4210,0.000412,4,1,5,29.886191135675617,#666666
4295,0.000094,0,1,1,12,#737373
4296,0.000094,0,1,1,12,#737373
4297,0.000094,0,1,1,12,#737373
4298,0.000094,0,1,1,12,#737373
4183,0.000094,0,1,1,12,#737373
4226,0.000094,0,1,1,12,#737373
4185,0.000094,0,1,1,12,#737373
4300,0.000094,0,1,1,12,#737373
4203,0.000491,5,1,6,33.14247108015606,#646464
4284,0.000253,2,1,3,22.323476700598142,#6b6b6b
4190,0.000118,1,0,1,13.900027528737976,#727272
4191,0.000118,1,0,1,13.900027528737976,#727272
4192,0.000118,1,0,1,13.900027528737976,#727272
4234,0.000094,0,1,1,12,#737373
4195,0.000348,4,0,4,27.03555831872816,#686868
4254,0.000094,0,1,1,12,#737373
4257,0.000094,0,1,1,12,#737373
4266,0.000094,0,1,1,12,#737373
4197,0.000126,1,0,1,14.493782114686502,#717171
4198,0.000126,1,0,1,14.493782114686502,#717171
4304,0.000094,0,1,1,12,#737373
4235,0.000094,0,1,1,12,#737373
4236,0.000094,0,1,1,12,#737373
4256,0.000094,0,1,1,12,#737373
4261,0.000094,0,1,1,12,#737373
4262,0.000094,0,1,1,12,#737373
4286,0.000094,0,1,1,12,#737373
4287,0.000094,0,1,1,12,#737373
4205,0.00015,1,0,1,16.180148347028588,#707070
4308,0.000094,0,1,1,12,#737373
4309,0.000094,0,1,1,12,#737373
4310,0.000094,0,1,1,12,#737373
4311,0.000094,0,1,1,12,#737373
4312,0.000094,0,1,1,12,#737373
4313,0.000094,0,1,1,12,#737373
4314,0.000094,0,1,1,12,#737373
4315,0.000094,0,1,1,12,#737373
4316,0.000094,0,1,1,12,#737373
4264,0.000094,0,3,3,12,#737373
4301,0.000253,2,1,3,22.323476700598142,#6b6b6b
4220,0.000121,1,0,1,14.124747288633095,#717171
4270,0.000094,0,1,1,12,#737373
4271,0.000094,0,1,1,12,#737373
4272,0.000094,0,1,1,12,#737373
4273,0.000094,0,1,1,12,#737373
4274,0.000094,0,1,1,12,#737373
4275,0.000094,0,1,1,12,#737373
4237,0.000133,1,0,1,14.999536055771733,#717171
4247,0.000094,0,1,1,12,#737373
4248,0.000094,0,1,1,12,#737373
4250,0.000133,1,0,1,14.999536055771733,#717171
4255,0.00012,1,0,1,14.050122216323361,#717171
4263,0.00012,1,0,1,14.050122216323361,#717171
4276,0.000173,1,0,1,17.685431661066666,#6f6f6f
4277,0.000173,1,0,1,17.685431661066666,#6f6f6f
4278,0.000173,1,0,1,17.685431661066666,#6f6f6f
4291,0.000332,3,1,4,26.28685674490043,#696969
4321,0.000094,0,1,1,12,#737373
4322,0.000094,0,1,1,12,#737373
4292,0.000094,0,1,1,12,#737373
4293,0.000094,0,1,1,12,#737373
4294,0.000094,0,1,1,12,#737373
4318,0.000094,0,1,1,12,#737373
4319,0.000094,0,1,1,12,#737373
4302,0.000094,0,1,1,12,#737373
4303,0.000094,0,1,1,12,#737373
4307,0.000094,0,1,1,12,#737373
4342,0.000513,6,3,9,34.006357828817116,#636363
4327,0.000383,5,0,5,28.621200567431316,#676767
4375,0.000108,1,3,4,13.13171952186635,#727272
4387,0.000094,0,1,1,12,#737373
4392,0.000136,2,8,10,15.212609940615039,#717171
4410,0.000094,0,4,4,12,#737373
4331,0.00012,1,2,3,14.050122216323361,#717171
4328,0.000249,2,0,2,22.108922047173674,#6c6c6c
4346,0.000369,7,3,10,27.995108790386844,#676767
4329,0.000164,2,0,2,17.10782210585562,#6f6f6f
4377,0.000094,0,4,4,12,#737373
4401,0.000131,3,5,8,14.856283440227312,#717171
4330,0.000116,1,0,1,13.748783606650441,#727272
4407,0.000094,0,3,3,12,#737373
4335,0.000162,4,2,6,16.977542788511858,#6f6f6f
4332,0.000955,11,0,11,48.784480149198636,#595959
4336,0.000682,8,1,9,40.15549823647371,#5f5f5f
4340,0.000178,3,3,6,18.000484217107044,#6f6f6f
4347,0.000133,3,4,7,14.999536055771733,#717171
4381,0.000137,3,8,11,15.283163521922663,#717171
4385,0.000105,1,3,4,12.895045046072177,#727272
4391,0.000119,2,7,9,13.975216770645698,#727272
4398,0.000101,1,5,6,12.57469176757538,#737373
4400,0.000094,0,2,2,12,#737373
4402,0.000094,0,10,10,12,#737373
4413,0.000094,0,7,7,12,#737373
4333,0.000512,7,0,7,33.96745636653713,#636363
4355,0.000148,2,1,3,16.044496277075513,#707070
4357,0.000166,3,4,7,17.237388412297367,#6f6f6f
4359,0.000491,7,3,10,33.14247108015606,#646464
4383,0.000157,3,3,6,16.648640101132177,#707070
4395,0.000109,1,10,11,13.209951757949934,#727272
4334,0.000162,1,0,1,16.977542788511858,#6f6f6f
4345,0.000615,11,3,14,37.81035382568078,#616161
4361,0.00031,7,3,10,25.230333578472866,#696969
4373,0.000198,4,7,11,19.222623922752323,#6e6e6e
4386,0.000128,2,2,4,14.639545810903515,#717171
4337,0.000156,2,0,2,16.582296788749808,#707070
4338,0.000239,1,0,1,21.56564352455313,#6c6c6c
4339,0.000144,1,0,1,15.770693283269225,#707070
4374,0.000196,3,5,8,19.102991324867094,#6e6e6e
4376,0.000161,2,4,6,16.912131765928624,#6f6f6f
4365,0.000212,4,2,6,20.045287013917818,#6d6d6d
4368,0.000205,3,4,7,19.63711638898998,#6d6d6d
4404,0.000193,2,4,6,18.92250746755846,#6e6e6e
4411,0.000094,0,2,2,12,#737373
4343,0.000406,4,0,4,29.627842349289,#666666
4399,0.000094,0,3,3,12,#737373
4352,0.000454,10,1,11,31.649259069339983,#656565
4344,0.000614,6,0,6,37.77450348352641,#616161
4384,0.000251,7,4,11,22.21639170604164,#6c6c6c
4408,0.000105,1,5,6,12.895045046072177,#727272
4406,0.000094,0,2,2,12,#737373
4409,0.000094,0,2,2,12,#737373
4419,0.000094,0,2,2,12,#737373
4360,0.000133,1,1,2,14.999536055771733,#717171
4417,0.000094,0,3,3,12,#737373
4418,0.000094,0,2,2,12,#737373
4348,0.00012,1,0,1,14.050122216323361,#717171
4349,0.000101,1,0,1,12.57469176757538,#737373
4351,0.000249,2,1,3,22.108922047173674,#6c6c6c
4350,0.000305,1,0,1,24.98555638836362,#6a6a6a
4416,0.000094,0,5,5,12,#737373
4363,0.000334,2,2,4,26.381319071802253,#696969
4353,0.000169,3,0,3,17.430428052850882,#6f6f6f
4396,0.000094,0,5,5,12,#737373
4412,0.000094,0,2,2,12,#737373
4354,0.000154,2,0,2,16.449033409962986,#707070
4403,0.000094,0,2,2,12,#737373
4356,0.000129,1,0,1,14.712043210723964,#717171
4358,0.000365,3,0,3,27.814270751789376,#686868
4364,0.000273,4,2,6,23.374098358988334,#6b6b6b
4371,0.000204,4,2,6,19.57829755448963,#6d6d6d
4372,0.000141,3,5,8,15.56308822919205,#707070
4380,0.000109,1,3,4,13.209951757949934,#727272
4388,0.000094,0,1,1,12,#737373
4405,0.000094,0,2,2,12,#737373
4369,0.000141,2,1,3,15.56308822919205,#707070
4370,0.000141,2,1,3,15.56308822919205,#707070
4367,0.00026,5,1,6,22.69530774034737,#6b6b6b
4366,0.000315,1,0,1,25.473340498053965,#696969
4397,0.000094,0,2,2,12,#737373
4378,0.00012,1,0,1,14.050122216323361,#717171
4379,0.000125,1,0,1,14.420509920674892,#717171
4382,0.00016,2,0,2,16.846537660321623,#6f6f6f
4389,0.000108,1,0,1,13.13171952186635,#727272
4390,0.000108,1,0,1,13.13171952186635,#727272
4393,0.000103,1,0,1,12.735568257100576,#727272
4394,0.000109,1,0,1,13.209951757949934,#727272
4414,0.000094,0,1,1,12,#737373
4421,0.000238,3,1,4,21.510757906638762,#6c6c6c
4420,0.000296,1,0,1,24.540360432916078,#6a6a6a
4436,0.000168,2,2,4,17.36625413094873,#6f6f6f
4442,0.000133,1,3,4,14.999536055771733,#717171
4424,0.000094,0,1,1,12,#737373
4422,0.000282,2,0,2,23.835537796096794,#6a6a6a
4432,0.000129,1,1,2,14.712043210723964,#717171
4430,0.000094,0,1,1,12,#737373
4429,0.000094,0,1,1,12,#737373
4427,0.000213,2,0,2,20.103098863481684,#6d6d6d
4443,0.000094,0,2,2,12,#737373
4433,0.000094,0,1,1,12,#737373
4434,0.000129,1,0,1,14.712043210723964,#717171
4439,0.000131,1,3,4,14.856283440227312,#717171
4441,0.000131,1,3,4,14.856283440227312,#717171
4438,0.000131,1,0,1,14.856283440227312,#717171
4440,0.000131,1,0,1,14.856283440227312,#717171
4447,0.000111,1,0,1,13.365453519669122,#727272
4449,0.000113,1,0,1,13.5196994710513,#727272
4450,0.000113,1,0,1,13.5196994710513,#727272
4454,0.000123,1,2,3,14.27316966065317,#717171
4451,0.000146,1,0,1,15.908016751672154,#707070
4452,0.000146,1,0,1,15.908016751672154,#707070
4455,0.000203,2,1,3,19.51934882871322,#6d6d6d
4453,0.000266,1,0,1,23.01044912007304,#6b6b6b
4456,0.000094,0,1,1,12,#737373
4463,0.000094,0,1,1,12,#737373
4464,0.000094,0,1,1,12,#737373
4465,0.000094,0,1,1,12,#737373
4466,0.000094,0,1,1,12,#737373
4460,0.000107,1,0,1,13.05316063235918,#727272
4485,0.00047,3,4,7,32.3014479342237,#646464
4467,0.000281,2,0,2,23.784597320863067,#6a6a6a
4553,0.000207,1,2,3,19.754368044230688,#6d6d6d
4468,0.000233,2,0,2,21.234758886801874,#6c6c6c
4613,0.000094,0,2,2,12,#737373
4469,0.000564,5,0,5,35.94711287743362,#626262
4526,0.000253,2,1,3,22.323476700598142,#6b6b6b
4602,0.000242,3,3,6,21.729683399131453,#6c6c6c
4626,0.000133,1,2,3,14.999536055771733,#717171
4796,0.000094,0,1,1,12,#737373
4639,0.000181,1,1,2,18.18760570927212,#6e6e6e
4470,0.000354,3,0,3,27.31231277408949,#686868
4676,0.000094,0,3,3,12,#737373
4766,0.000094,0,1,1,12,#737373
4475,0.000173,1,1,2,17.685431661066666,#6f6f6f
4471,0.000329,2,0,2,26.14468175968276,#696969
4590,0.000207,1,2,3,19.754368044230688,#6d6d6d
4671,0.00012,1,1,2,14.050122216323361,#717171
4472,0.000196,1,0,1,19.102991324867094,#6e6e6e
4474,0.00039,3,1,4,28.930381542039342,#676767
4473,0.000985,5,0,5,49.66029719261307,#595959
4508,0.00031,3,1,4,25.230333578472866,#696969
4605,0.000303,1,2,3,24.887140432028936,#6a6a6a
4617,0.000094,0,2,2,12,#737373
4646,0.00015,1,1,2,16.180148347028588,#707070
4867,0.000279,3,4,7,23.682471018741992,#6b6b6b
4559,0.000094,0,1,1,12,#737373
4477,0.000417,2,1,3,30.10019115109451,#666666
4662,0.000094,0,4,4,12,#737373
4574,0.000292,3,2,5,24.340542711983574,#6a6a6a
4832,0.000235,3,1,4,21.345475258565315,#6c6c6c
4479,0.000122,1,1,2,14.199095341257646,#717171
4481,0.000122,1,1,2,14.199095341257646,#717171
4480,0.000297,2,0,2,24.590124646255656,#6a6a6a
4483,0.000159,2,1,3,16.78075881014393,#6f6f6f
4482,0.000396,3,0,3,29.193411658840844,#676767
4772,0.000094,0,1,1,12,#737373
4501,0.000094,0,2,2,12,#737373
4540,0.000347,2,1,3,26.989224450772824,#686868
4484,0.000428,2,0,2,30.566965295087698,#666666
4688,0.000094,0,2,2,12,#737373
4496,0.000196,1,1,2,19.102991324867094,#6e6e6e
4530,0.000133,1,1,2,14.999536055771733,#717171
4601,0.000113,1,1,2,13.5196994710513,#727272
4487,0.000331,2,1,3,26.23952956349499,#696969
4486,0.000626,3,0,3,38.20299036682627,#606060
4533,0.000162,1,1,2,16.977542788511858,#6f6f6f
4550,0.000133,1,1,2,14.999536055771733,#717171
4588,0.000409,2,2,4,29.757229929753784,#666666
4703,0.00015,1,2,3,16.180148347028588,#707070
4529,0.000196,1,1,2,19.102991324867094,#6e6e6e
4488,0.000463,2,0,2,32.01736471555461,#656565
4562,0.000239,3,1,4,21.56564352455313,#6c6c6c
4489,0.000258,2,0,2,22.58953495795189,#6b6b6b
4610,0.000133,1,1,2,14.999536055771733,#717171
4500,0.000292,3,2,5,24.340542711983574,#6a6a6a
4490,0.000244,2,0,2,21.838535319500465,#6c6c6c
4648,0.000094,0,3,3,12,#737373
4492,0.000216,2,1,3,20.275805650131435,#6d6d6d
4580,0.000094,0,1,1,12,#737373
4584,0.000094,0,2,2,12,#737373
4669,0.000094,0,2,2,12,#737373
4543,0.000113,1,1,2,13.5196994710513,#727272
4510,0.00015,1,1,2,16.180148347028588,#707070
4493,0.000465,4,0,4,32.0987273958043,#656565
4616,0.00016,2,1,3,16.846537660321623,#6f6f6f
4797,0.000094,0,1,1,12,#737373
4596,0.000094,0,2,2,12,#737373
4494,0.000173,2,0,2,17.685431661066666,#6f6f6f
4702,0.000094,0,2,2,12,#737373
4495,0.000208,2,0,2,19.812802667928878,#6d6d6d
4659,0.000094,0,3,3,12,#737373
4767,0.000241,1,2,3,21.675105650777578,#6c6c6c
4547,0.00016,1,2,3,16.846537660321623,#6f6f6f
4497,0.000376,3,0,3,28.30946605998667,#676767
4606,0.000157,1,2,3,16.648640101132177,#707070
4798,0.000173,1,1,2,17.685431661066666,#6f6f6f
4499,0.00012,1,1,2,14.050122216323361,#717171
4498,0.00032,2,0,2,25.714617749683157,#696969
4674,0.000094,0,3,3,12,#737373
4764,0.000094,0,1,1,12,#737373
4765,0.000094,0,1,1,12,#737373
4503,0.000207,2,1,3,19.754368044230688,#6d6d6d
4502,0.000269,1,0,1,23.166819740335022,#6b6b6b
4561,0.000173,1,2,3,17.685431661066666,#6f6f6f
4522,0.000314,3,1,4,25.424878764011332,#696969
4504,0.000387,2,0,2,28.79818377446482,#676767
4589,0.000094,0,3,3,12,#737373
4506,0.000224,2,1,3,20.731153739353275,#6d6d6d
4505,0.000397,2,0,2,29.237075180617616,#676767
4600,0.000133,1,1,2,14.999536055771733,#717171
4546,0.00012,1,1,2,14.050122216323361,#717171
4542,0.00019,2,2,4,18.740756670053315,#6e6e6e
4575,0.000113,1,1,2,13.5196994710513,#727272
4636,0.000094,0,2,2,12,#737373
4664,0.000094,0,3,3,12,#737373
4643,0.000139,1,3,4,15.423579008661793,#707070
4511,0.000173,2,0,2,17.685431661066666,#6f6f6f
4518,0.00036,3,1,4,27.586964296887757,#686868
4512,0.000889,4,0,4,46.81294885107635,#5b5b5b
4607,0.000436,2,1,3,30.903054430226412,#656565
4696,0.000094,0,1,1,12,#737373
4514,0.000094,0,1,1,12,#737373
4513,0.000337,3,0,3,26.52253662605617,#696969
4581,0.000147,2,1,3,15.97636096389552,#707070
4598,0.000094,0,2,2,12,#737373
4585,0.0002,2,1,3,19.341713958828393,#6e6e6e
4515,0.000303,2,0,2,24.887140432028936,#6a6a6a
4517,0.000142,1,1,2,15.632508821476176,#707070
4516,0.000361,3,0,3,27.632538684601606,#686868
4554,0.000253,2,2,4,22.323476700598142,#6b6b6b
4614,0.000094,0,2,2,12,#737373
4661,0.000113,1,2,3,13.5196994710513,#727272
4691,0.000173,1,2,3,17.685431661066666,#6f6f6f
4778,0.000094,0,1,1,12,#737373
4782,0.000133,1,1,2,14.999536055771733,#717171
4520,0.000585,7,1,8,36.723150329799296,#616161
4519,0.000631,2,0,2,38.380434439832854,#606060
4597,0.000094,0,2,2,12,#737373
4521,0.000094,0,1,1,12,#737373
4592,0.000173,1,2,3,17.685431661066666,#6f6f6f
4620,0.000173,1,2,3,17.685431661066666,#6f6f6f
4699,0.000094,0,3,3,12,#737373
4800,0.000094,0,1,1,12,#737373
4801,0.000094,0,1,1,12,#737373
4802,0.000094,0,1,1,12,#737373
4768,0.000094,0,2,2,12,#737373
4545,0.000094,0,2,2,12,#737373
4523,0.000153,2,0,2,16.382109723928565,#707070
4654,0.000094,0,4,4,12,#737373
4579,0.000133,1,3,4,14.999536055771733,#717171
4524,0.000158,2,0,2,16.714793528209434,#707070
4686,0.000094,0,5,5,12,#737373
4525,0.000149,2,0,2,16.112424734781012,#707070
4803,0.000094,0,1,1,12,#737373
4804,0.000094,0,1,1,12,#737373
4528,0.00016,2,1,3,16.846537660321623,#6f6f6f
4527,0.000229,1,0,1,21.012035273453705,#6c6c6c
4687,0.000094,0,2,2,12,#737373
4531,0.00028,3,0,3,23.7335752027898,#6a6a6a
4611,0.000094,0,3,3,12,#737373
4650,0.000094,0,1,1,12,#737373
4532,0.000205,3,0,3,19.63711638898998,#6d6d6d
4651,0.00016,3,3,6,16.846537660321623,#6f6f6f
4826,0.000094,0,3,3,12,#737373
4534,0.000607,5,0,5,37.522811626822715,#616161
4541,0.000286,2,1,3,24.03849160370686,#6a6a6a
4618,0.000094,0,1,1,12,#737373
4673,0.000133,1,1,2,14.999536055771733,#717171
4722,0.00012,1,2,3,14.050122216323361,#717171
4567,0.00036,1,2,3,27.586964296887757,#686868
4537,0.000371,4,0,4,28.085196944357673,#676767
4866,0.000153,1,3,4,16.382109723928565,#707070
4538,0.000398,5,0,5,29.28068923771282,#676767
4771,0.000094,0,3,3,12,#737373
4805,0.000094,0,1,1,12,#737373
4806,0.000094,0,1,1,12,#737373
4807,0.000094,0,1,1,12,#737373
4763,0.000094,0,2,2,12,#737373
4539,0.000292,3,0,3,24.340542711983574,#6a6a6a
4808,0.000094,0,1,1,12,#737373
4809,0.000094,0,1,1,12,#737373
4789,0.000094,0,1,1,12,#737373
4816,0.000173,1,1,2,17.685431661066666,#6f6f6f
4675,0.000133,1,2,3,14.999536055771733,#717171
4799,0.000094,0,2,2,12,#737373
4544,0.000131,1,0,1,14.856283440227312,#717171
4700,0.000094,0,3,3,12,#737373
4549,0.0002,2,1,3,19.341713958828393,#6e6e6e
4548,0.000343,2,0,2,26.803285186298606,#686868
4638,0.000094,0,1,1,12,#737373
4576,0.000094,0,1,1,12,#737373
4624,0.000094,0,2,2,12,#737373
4551,0.000235,2,0,2,21.345475258565315,#6c6c6c
4586,0.00012,1,1,2,14.050122216323361,#717171
4627,0.000349,2,1,3,27.081832310819312,#686868
4719,0.000133,1,2,3,14.999536055771733,#717171
4568,0.000133,1,1,2,14.999536055771733,#717171
4666,0.000094,0,1,1,12,#737373
4701,0.000094,0,1,1,12,#737373
4555,0.000205,2,0,2,19.63711638898998,#6d6d6d
4556,0.000308,2,0,2,25.13263746265548,#696969
4670,0.000221,2,1,3,20.56126952844315,#6d6d6d
4557,0.000206,2,0,2,19.695806249957098,#6d6d6d
4558,0.00012,1,0,1,14.050122216323361,#717171
4622,0.000094,0,3,3,12,#737373
4560,0.000188,2,0,2,18.618871286344486,#6e6e6e
4811,0.000094,0,1,1,12,#737373
4612,0.000094,0,1,1,12,#737373
4679,0.000094,0,2,2,12,#737373
4684,0.000094,0,2,2,12,#737373
4565,0.000396,2,1,3,29.193411658840844,#676767
4564,0.000737,5,0,5,42.00405684881537,#5e5e5e
4813,0.000094,0,1,1,12,#737373
4814,0.000094,0,1,1,12,#737373
4815,0.000094,0,1,1,12,#737373
4640,0.000275,2,1,3,23.477225028974956,#6b6b6b
4566,0.000286,2,0,2,24.03849160370686,#6a6a6a
4667,0.000314,2,1,3,25.424878764011332,#696969
4637,0.000173,1,2,3,17.685431661066666,#6f6f6f
4569,0.000212,2,0,2,20.045287013917818,#6d6d6d
4571,0.000126,1,1,2,14.493782114686502,#717171
4621,0.000196,1,2,3,19.102991324867094,#6e6e6e
4761,0.000173,1,2,3,17.685431661066666,#6f6f6f
4572,0.000192,1,0,1,18.862066054200255,#6e6e6e
4594,0.000094,0,1,1,12,#737373
4595,0.000094,0,1,1,12,#737373
4656,0.000094,0,2,2,12,#737373
4820,0.000094,0,4,4,12,#737373
4577,0.000225,2,0,2,20.787553985810852,#6d6d6d
4578,0.000145,1,0,1,15.839461562490118,#707070
4583,0.0002,2,0,2,19.341713958828393,#6e6e6e
4623,0.000094,0,1,1,12,#737373
4587,0.000094,0,1,1,12,#737373
4694,0.000164,1,2,3,17.10782210585562,#6f6f6f
4788,0.000289,1,1,2,24.189869906310776,#6a6a6a
4657,0.000133,1,1,2,14.999536055771733,#717171
4665,0.000094,0,1,1,12,#737373
4591,0.0002,2,0,2,19.341713958828393,#6e6e6e
4723,0.000094,0,3,3,12,#737373
4635,0.000094,0,1,1,12,#737373
4593,0.00012,1,0,1,14.050122216323361,#717171
4599,0.000113,1,0,1,13.5196994710513,#727272
4641,0.000241,1,2,3,21.675105650777578,#6c6c6c
4604,0.000222,1,0,1,20.61801225297066,#6d6d6d
4619,0.000247,2,1,3,22.0010632357656,#6c6c6c
4608,0.000207,3,1,4,19.754368044230688,#6d6d6d
4630,0.000196,1,1,2,19.102991324867094,#6e6e6e
4644,0.000107,1,2,3,13.05316063235918,#727272
4690,0.000094,0,2,2,12,#737373
4609,0.000189,2,0,2,18.67988652940294,#6e6e6e
4773,0.000094,0,1,1,12,#737373
4615,0.000153,2,0,2,16.382109723928565,#707070
4683,0.000094,0,3,3,12,#737373
4791,0.000094,0,2,2,12,#737373
4625,0.000094,0,1,1,12,#737373
4776,0.000094,0,1,1,12,#737373
4633,0.00012,1,1,2,14.050122216323361,#717171
4786,0.000094,0,2,2,12,#737373
4733,0.000326,3,2,5,26.00192217315449,#696969
4653,0.000113,1,1,2,13.5196994710513,#727272
4629,0.00019,1,0,1,18.740756670053315,#6e6e6e
4672,0.00012,1,1,2,14.050122216323361,#717171
4642,0.000094,0,1,1,12,#737373
4689,0.000207,2,2,4,19.754368044230688,#6d6d6d
4821,0.000094,0,1,1,12,#737373
4645,0.000173,1,1,2,17.685431661066666,#6f6f6f
4668,0.000094,0,1,1,12,#737373
4647,0.00012,1,0,1,14.050122216323361,#717171
4739,0.000133,1,3,4,14.999536055771733,#717171
4750,0.000109,1,1,2,13.209951757949934,#727272
4658,0.000148,2,0,2,16.044496277075513,#707070
4663,0.00012,1,0,1,14.050122216323361,#717171
4779,0.000241,1,1,2,21.675105650777578,#6c6c6c
4827,0.000094,0,2,2,12,#737373
4823,0.000094,0,2,2,12,#737373
4680,0.00012,1,0,1,14.050122216323361,#717171
4681,0.0002,2,0,2,19.341713958828393,#6e6e6e
4825,0.000094,0,1,1,12,#737373
4682,0.00012,1,0,1,14.050122216323361,#717171
4685,0.000136,2,0,2,15.212609940615039,#717171
4781,0.000094,0,1,1,12,#737373
4692,0.000163,1,0,1,17.042772364524353,#6f6f6f
4693,0.000164,1,0,1,17.10782210585562,#6f6f6f
4927,0.000181,1,1,2,18.18760570927212,#6e6e6e
4697,0.0002,2,0,2,19.341713958828393,#6e6e6e
4818,0.000094,0,1,1,12,#737373
4698,0.00012,1,0,1,14.050122216323361,#717171
4793,0.000133,1,2,3,14.999536055771733,#717171
4711,0.000133,1,1,2,14.999536055771733,#717171
4704,0.000247,2,0,2,22.0010632357656,#6c6c6c
4746,0.000094,0,2,2,12,#737373
4714,0.000094,0,2,2,12,#737373
4705,0.000173,2,0,2,17.685431661066666,#6f6f6f
4745,0.000094,0,2,2,12,#737373
4716,0.000094,0,2,2,12,#737373
4706,0.00019,2,0,2,18.740756670053315,#6e6e6e
4713,0.000133,1,1,2,14.999536055771733,#717171
4707,0.000247,2,0,2,22.0010632357656,#6c6c6c
4728,0.000133,1,4,5,14.999536055771733,#717171
4708,0.000419,5,0,5,30.18546759115748,#666666
4729,0.000094,0,2,2,12,#737373
4752,0.000094,0,1,1,12,#737373
4709,0.000162,2,0,2,16.977542788511858,#6f6f6f
4710,0.000247,2,0,2,22.0010632357656,#6c6c6c
4724,0.000133,1,1,2,14.999536055771733,#717171
4735,0.000094,0,2,2,12,#737373
4727,0.000292,3,3,6,24.340542711983574,#6a6a6a
4712,0.000205,2,0,2,19.63711638898998,#6d6d6d
4732,0.000094,0,2,2,12,#737373
4715,0.000192,2,0,2,18.862066054200255,#6e6e6e
4751,0.000094,0,5,5,12,#737373
4720,0.000133,1,1,2,14.999536055771733,#717171
4717,0.000235,2,0,2,21.345475258565315,#6c6c6c
4731,0.000133,1,1,2,14.999536055771733,#717171
4718,0.000318,2,0,2,25.61831187604224,#696969
4737,0.000131,1,1,2,14.856283440227312,#717171
4736,0.000094,0,2,2,12,#737373
4721,0.000362,3,0,3,27.678056297441284,#686868
4755,0.000253,2,1,3,22.323476700598142,#6b6b6b
4725,0.000203,2,0,2,19.51934882871322,#6d6d6d
4754,0.000094,0,3,3,12,#737373
4726,0.000262,3,0,3,22.800715014747656,#6b6b6b
4756,0.000094,0,1,1,12,#737373
4784,0.000094,0,3,3,12,#737373
4774,0.000094,0,1,1,12,#737373
4775,0.000094,0,1,1,12,#737373
4748,0.000094,0,2,2,12,#737373
4730,0.000149,2,0,2,16.112424734781012,#707070
4738,0.000094,0,2,2,12,#737373
4740,0.000133,1,1,2,14.999536055771733,#717171
4757,0.000094,0,1,1,12,#737373
4734,0.000226,2,0,2,20.843841544046825,#6d6d6d
4744,0.000109,1,1,2,13.209951757949934,#727272
4742,0.000094,0,2,2,12,#737373
4747,0.000094,0,2,2,12,#737373
4741,0.000173,2,0,2,17.685431661066666,#6f6f6f
4758,0.000094,0,1,1,12,#737373
4812,0.000094,0,1,1,12,#737373
4760,0.000167,1,0,1,17.301908082944657,#6f6f6f
4777,0.000094,0,1,1,12,#737373
4762,0.000133,1,0,1,14.999536055771733,#717171
4769,0.000173,1,1,2,17.685431661066666,#6f6f6f
4770,0.000094,0,1,1,12,#737373
4780,0.000173,1,1,2,17.685431661066666,#6f6f6f
4824,0.000094,0,1,1,12,#737373
4783,0.00012,1,0,1,14.050122216323361,#717171
4785,0.000133,1,0,1,14.999536055771733,#717171
4794,0.000094,0,2,2,12,#737373
4787,0.000133,1,0,1,14.999536055771733,#717171
4792,0.00023,2,1,3,21.067879224360784,#6c6c6c
4790,0.000133,1,0,1,14.999536055771733,#717171
4795,0.000094,0,1,1,12,#737373
4822,0.000094,0,1,1,12,#737373
4810,0.000133,1,0,1,14.999536055771733,#717171
4817,0.000094,0,1,1,12,#737373
4819,0.000113,1,0,1,13.5196994710513,#727272
4828,0.000183,3,0,3,18.311578797501046,#6e6e6e
4884,0.000094,0,3,3,12,#737373
4829,0.000285,2,0,2,23.987873541279562,#6a6a6a
4874,0.000174,2,1,3,17.748766657369394,#6f6f6f
4899,0.00012,1,2,3,14.050122216323361,#717171
4841,0.000207,2,2,4,19.754368044230688,#6d6d6d
4889,0.000094,0,3,3,12,#737373
4896,0.000133,1,1,2,14.999536055771733,#717171
4833,0.000364,2,0,2,27.76892210605493,#686868
4898,0.000184,2,1,3,18.373336658075203,#6e6e6e
4847,0.000262,2,1,3,22.800715014747656,#6b6b6b
4834,0.000422,3,0,3,30.313039565996917,#666666
4916,0.000094,0,1,1,12,#737373
4923,0.000094,0,3,3,12,#737373
4836,0.000206,4,1,5,19.695806249957098,#6d6d6d
4835,0.000269,1,0,1,23.166819740335022,#6b6b6b
4881,0.000094,0,2,2,12,#737373
4838,0.000213,3,0,3,20.103098863481684,#6d6d6d
4890,0.000094,0,2,2,12,#737373
4904,0.000094,0,2,2,12,#737373
4903,0.000133,1,1,2,14.999536055771733,#717171
4839,0.000247,2,0,2,22.0010632357656,#6c6c6c
4840,0.0004,4,0,4,29.367769677189468,#676767
4842,0.000094,0,1,1,12,#737373
4843,0.000094,0,1,1,12,#737373
4844,0.000094,0,1,1,12,#737373
4887,0.00012,1,3,4,14.050122216323361,#717171
4848,0.00023,3,2,5,21.067879224360784,#6c6c6c
4846,0.000191,1,0,1,18.801482814356014,#6e6e6e
4873,0.000197,1,2,3,19.16287594224734,#6e6e6e
4900,0.000094,0,3,3,12,#737373
4908,0.000173,1,2,3,17.685431661066666,#6f6f6f
4909,0.000094,0,2,2,12,#737373
4922,0.000094,0,2,2,12,#737373
4851,0.000237,2,0,2,21.455768414852855,#6c6c6c
4892,0.000122,1,1,2,14.199095341257646,#717171
4860,0.000094,0,3,3,12,#737373
4852,0.00016,2,0,2,16.846537660321623,#6f6f6f
4853,0.000142,1,0,1,15.632508821476176,#707070
4856,0.000231,2,0,2,21.123614021758055,#6c6c6c
4871,0.000122,1,1,2,14.199095341257646,#717171
4857,0.000128,1,0,1,14.639545810903515,#717171
4858,0.00012,1,0,1,14.050122216323361,#717171
4863,0.000219,1,1,2,20.447436343276856,#6d6d6d
4877,0.000148,1,1,2,16.044496277075513,#707070
4879,0.00012,1,2,3,14.050122216323361,#717171
4868,0.000094,0,1,1,12,#737373
4869,0.000094,0,1,1,12,#737373
4925,0.000094,0,3,3,12,#737373
4880,0.0002,2,1,3,19.341713958828393,#6e6e6e
4870,0.000429,2,0,2,30.609130121369745,#666666
4913,0.000196,1,1,2,19.102991324867094,#6e6e6e
4872,0.00037,4,0,4,28.040180259078173,#676767
4905,0.000094,0,2,2,12,#737373
4917,0.000133,1,1,2,14.999536055771733,#717171
4891,0.000122,1,1,2,14.199095341257646,#717171
4914,0.000094,0,2,2,12,#737373
4920,0.000094,0,1,1,12,#737373
4924,0.000094,0,3,3,12,#737373
4915,0.000094,0,1,1,12,#737373
4886,0.00019,2,1,3,18.740756670053315,#6e6e6e
4895,0.00012,1,0,1,14.050122216323361,#717171
4926,0.000094,0,2,2,12,#737373
4901,0.000239,4,0,4,21.56564352455313,#6c6c6c
4907,0.000094,0,2,2,12,#737373
4921,0.000094,0,2,2,12,#737373
4906,0.000207,2,0,2,19.754368044230688,#6d6d6d
4919,0.000094,0,1,1,12,#737373
4910,0.00016,2,0,2,16.846537660321623,#6f6f6f
4911,0.000133,1,0,1,14.999536055771733,#717171
4912,0.00012,1,0,1,14.050122216323361,#717171
4918,0.00012,1,1,2,14.050122216323361,#717171
4929,0.000133,1,1,2,14.999536055771733,#717171
4938,0.000094,0,2,2,12,#737373
4931,0.000094,0,1,1,12,#737373
4937,0.000094,0,2,2,12,#737373
4932,0.000233,2,0,2,21.234758886801874,#6c6c6c
4935,0.000133,1,1,2,14.999536055771733,#717171
4933,0.000233,2,0,2,21.234758886801874,#6c6c6c
4939,0.000133,1,1,2,14.999536055771733,#717171
4936,0.000133,1,0,1,14.999536055771733,#717171
